"","UWI","SURFX","SURFY","DATE","INJ","cum_inj","tol_inj","CUMU_INJ"
"1","42121329540000",2073356.964,541393.3458,2007-10-01,139190,139190,40070952,6483309
"2","42121329540000",2073356.964,541393.3458,2007-11-01,136895,276085,40070952,6157035
"3","42121329540000",2073356.964,541393.3458,2007-12-01,219990,496075,40070952,5777613
"4","42121329540000",2073356.964,541393.3458,2008-01-01,215300,711375,40070952,6452815
"5","42121329540000",2073356.964,541393.3458,2008-02-01,262620,973995,40070952,7775520
"6","42121329540000",2073356.964,541393.3458,2008-03-01,274480,1248475,40070952,9152519
"7","42121329540000",2073356.964,541393.3458,2008-04-01,266285,1514760,40070952,8881211
"8","42121329540000",2073356.964,541393.3458,2008-05-01,286615,1801375,40070952,9790992
"9","42121329540000",2073356.964,541393.3458,2008-06-01,266740,2068115,40070952,9489076
"10","42121329540000",2073356.964,541393.3458,2008-07-01,194800,2262915,40070952,9342850
"11","42121329540000",2073356.964,541393.3458,2008-08-01,268660,2531575,40070952,9977335
"12","42121329540000",2073356.964,541393.3458,2008-09-01,146610,2678185,40070952,9513587
"13","42121329540000",2073356.964,541393.3458,2008-10-01,183960,2862145,40070952,9729575
"14","42121329540000",2073356.964,541393.3458,2008-11-01,259990,3122135,40070952,10178583
"15","42121329540000",2073356.964,541393.3458,2008-12-01,180050,3302185,40070952,9857864
"16","42121329540000",2073356.964,541393.3458,2009-01-01,323150,3625335,40070952,9714975
"17","42121329540000",2073356.964,541393.3458,2009-02-01,230191,3855526,40070952,9563848
"18","42121329540000",2073356.964,541393.3458,2009-03-01,268139,4123665,40070952,10011008
"19","42121329540000",2073356.964,541393.3458,2009-04-01,321031,4444696,40070952,8817835
"20","42121329540000",2073356.964,541393.3458,2009-05-01,158163,4602859,40070952,9222275
"21","42121329540000",2073356.964,541393.3458,2009-06-01,83251,4686110,40070952,8823798
"22","42121329540000",2073356.964,541393.3458,2009-07-01,214413,4900523,40070952,9681047
"23","42121329540000",2073356.964,541393.3458,2009-08-01,245648,5146171,40070952,10148823
"24","42121329540000",2073356.964,541393.3458,2009-09-01,252160,5398331,40070952,9880092
"25","42121329540000",2073356.964,541393.3458,2009-10-01,245395,5643726,40070952,10866851
"26","42121329540000",2073356.964,541393.3458,2009-11-01,247772,5891498,40070952,10107974
"27","42121329540000",2073356.964,541393.3458,2009-12-01,193458,6084956,40070952,10176315
"28","42121329540000",2073356.964,541393.3458,2010-01-01,164840,6249796,40070952,10900701
"29","42121329540000",2073356.964,541393.3458,2010-02-01,221707,6471503,40070952,10320596
"30","42121329540000",2073356.964,541393.3458,2010-03-01,249038,6720541,40070952,12054256
"31","42121329540000",2073356.964,541393.3458,2010-04-01,220413,6940954,40070952,11657482
"32","42121329540000",2073356.964,541393.3458,2010-05-01,243882,7184836,40070952,12361540
"33","42121329540000",2073356.964,541393.3458,2010-06-01,261510,7446346,40070952,11806317
"34","42121329540000",2073356.964,541393.3458,2010-07-01,382329,7828675,40070952,13014429
"35","42121329540000",2073356.964,541393.3458,2010-08-01,447765,8276440,40070952,12894731
"36","42121329540000",2073356.964,541393.3458,2010-09-01,442734,8719174,40070952,13014299
"37","42121329540000",2073356.964,541393.3458,2010-10-01,316689,9035863,40070952,11689154
"38","42121329540000",2073356.964,541393.3458,2010-11-01,353303,9389166,40070952,11954124
"39","42121329540000",2073356.964,541393.3458,2010-12-01,356534,9745700,40070952,12386935
"40","42121329540000",2073356.964,541393.3458,2011-01-01,325513,10071213,40070952,12491622
"41","42121329540000",2073356.964,541393.3458,2011-02-01,335765,10406978,40070952,10744516
"42","42121329540000",2073356.964,541393.3458,2011-03-01,620546,11027524,40070952,13585658
"43","42121329540000",2073356.964,541393.3458,2011-04-01,546534,11574058,40070952,13823700
"44","42121329540000",2073356.964,541393.3458,2011-05-01,644749,12218807,40070952,14893483
"45","42121329540000",2073356.964,541393.3458,2011-06-01,437211,12656018,40070952,13536023
"46","42121329540000",2073356.964,541393.3458,2011-07-01,405175,13061193,40070952,14060435
"47","42121329540000",2073356.964,541393.3458,2011-08-01,445605,13506798,40070952,13865713
"48","42121329540000",2073356.964,541393.3458,2011-09-01,514298,14021096,40070952,13575950
"49","42121329540000",2073356.964,541393.3458,2011-10-01,394573,14415669,40070952,14224672
"50","42121329540000",2073356.964,541393.3458,2011-11-01,306239,14721908,40070952,14289379
"51","42121329540000",2073356.964,541393.3458,2011-12-01,328365,15050273,40070952,14301497
"52","42121329540000",2073356.964,541393.3458,2012-01-01,433219,15483492,40070952,14393197
"53","42121329540000",2073356.964,541393.3458,2012-02-01,395394,15878886,40070952,13261820
"54","42121329540000",2073356.964,541393.3458,2012-03-01,425413,16304299,40070952,14719295
"55","42121329540000",2073356.964,541393.3458,2012-04-01,318855,16623154,40070952,13422939
"56","42121329540000",2073356.964,541393.3458,2012-05-01,440615,17063769,40070952,13619470
"57","42121329540000",2073356.964,541393.3458,2012-06-01,357882,17421651,40070952,12965656
"58","42121329540000",2073356.964,541393.3458,2012-07-01,504884,17926535,40070952,13735215
"59","42121329540000",2073356.964,541393.3458,2012-08-01,415474,18342009,40070952,13116786
"60","42121329540000",2073356.964,541393.3458,2012-09-01,373665,18715674,40070952,12508392
"61","42121329540000",2073356.964,541393.3458,2012-10-01,299695,19015369,40070952,12829987
"62","42121329540000",2073356.964,541393.3458,2012-11-01,395409,19410778,40070952,11811242
"63","42121329540000",2073356.964,541393.3458,2012-12-01,388504,19799282,40070952,12077125
"64","42121329540000",2073356.964,541393.3458,2013-01-01,408199,20207481,40070952,12754328
"65","42121329540000",2073356.964,541393.3458,2013-02-01,380207,20587688,40070952,11309584
"66","42121329540000",2073356.964,541393.3458,2013-03-01,364254,20951942,40070952,12445227
"67","42121329540000",2073356.964,541393.3458,2013-04-01,392514,21344456,40070952,11899338
"68","42121329540000",2073356.964,541393.3458,2013-05-01,474744,21819200,40070952,11963242
"69","42121329540000",2073356.964,541393.3458,2013-06-01,420394,22239594,40070952,11514151
"70","42121329540000",2073356.964,541393.3458,2013-07-01,423387,22662981,40070952,12334827
"71","42121329540000",2073356.964,541393.3458,2013-08-01,371575,23034556,40070952,12036527
"72","42121329540000",2073356.964,541393.3458,2013-09-01,390916,23425472,40070952,11831621
"73","42121329540000",2073356.964,541393.3458,2013-10-01,389960,23815432,40070952,11912081
"74","42121329540000",2073356.964,541393.3458,2013-11-01,419748,24235180,40070952,11402351
"75","42121329540000",2073356.964,541393.3458,2013-12-01,454106,24689286,40070952,10800800
"76","42121329540000",2073356.964,541393.3458,2014-01-01,518817,25208103,40070952,11386084
"77","42121329540000",2073356.964,541393.3458,2014-02-01,415545,25623648,40070952,9936683
"78","42121329540000",2073356.964,541393.3458,2014-03-01,538736,26162384,40070952,12046987
"79","42121329540000",2073356.964,541393.3458,2014-04-01,437254,26599638,40070952,11738869
"80","42121329540000",2073356.964,541393.3458,2014-05-01,459573,27059211,40070952,12165041
"81","42121329540000",2073356.964,541393.3458,2014-06-01,451512,27510723,40070952,11720072
"82","42121329540000",2073356.964,541393.3458,2014-07-01,483309,27994032,40070952,11632955
"83","42121329540000",2073356.964,541393.3458,2014-08-01,381846,28375878,40070952,11280396
"84","42121329540000",2073356.964,541393.3458,2014-09-01,286020,28661898,40070952,10707843
"85","42121329540000",2073356.964,541393.3458,2014-10-01,332496,28994394,40070952,11154961
"86","42121329540000",2073356.964,541393.3458,2014-11-01,425867,29420261,40070952,11006198
"87","42121329540000",2073356.964,541393.3458,2014-12-01,449789,29870050,40070952,11175048
"88","42121329540000",2073356.964,541393.3458,2015-01-01,438144,30308194,40070952,11188192
"89","42121329540000",2073356.964,541393.3458,2015-02-01,324193,30632387,40070952,9285348
"90","42121329540000",2073356.964,541393.3458,2015-03-01,344573,30976960,40070952,11132951
"91","42121329540000",2073356.964,541393.3458,2015-04-01,407501,31384461,40070952,10228970
"92","42121329540000",2073356.964,541393.3458,2015-05-01,486758,31871219,40070952,10731832
"93","42121329540000",2073356.964,541393.3458,2015-06-01,479982,32351201,40070952,10019178
"94","42121329540000",2073356.964,541393.3458,2015-07-01,414021,32765222,40070952,9556838
"95","42121329540000",2073356.964,541393.3458,2015-08-01,447485,33212707,40070952,9046352
"96","42121329540000",2073356.964,541393.3458,2015-09-01,246949,33459656,40070952,8436833
"97","42121329540000",2073356.964,541393.3458,2015-10-01,329093,33788749,40070952,8702949
"98","42121329540000",2073356.964,541393.3458,2015-11-01,432679,34221428,40070952,8702391
"99","42121329540000",2073356.964,541393.3458,2015-12-01,389704,34611132,40070952,8797617
"100","42121329540000",2073356.964,541393.3458,2016-01-01,363427,34974559,40070952,8785697
"101","42121329540000",2073356.964,541393.3458,2016-02-01,354133,35328692,40070952,8098391
"102","42121329540000",2073356.964,541393.3458,2016-03-01,398800,35727492,40070952,8313445
"103","42121329540000",2073356.964,541393.3458,2016-04-01,300702,36028194,40070952,8067410
"104","42121329540000",2073356.964,541393.3458,2016-05-01,265823,36294017,40070952,8687363
"105","42121329540000",2073356.964,541393.3458,2016-06-01,256678,36550695,40070952,8474598
"106","42121329540000",2073356.964,541393.3458,2016-07-01,252463,36803158,40070952,8474294
"107","42121329540000",2073356.964,541393.3458,2016-08-01,269007,37072165,40070952,8424724
"108","42121329540000",2073356.964,541393.3458,2016-09-01,234765,37306930,40070952,7958587
"109","42121329540000",2073356.964,541393.3458,2016-10-01,261396,37568326,40070952,7328643
"110","42121329540000",2073356.964,541393.3458,2016-11-01,251526,37819852,40070952,7108192
"111","42121329540000",2073356.964,541393.3458,2016-12-01,245313,38065165,40070952,7206177
"112","42121329540000",2073356.964,541393.3458,2017-01-01,249055,38314220,40070952,8191419
"113","42121329540000",2073356.964,541393.3458,2017-02-01,201241,38515461,40070952,7284679
"114","42121329540000",2073356.964,541393.3458,2017-03-01,211013,38726474,40070952,7793859
"115","42121329540000",2073356.964,541393.3458,2017-04-01,187989,38914463,40070952,7558837
"116","42121329540000",2073356.964,541393.3458,2017-05-01,215822,39130285,40070952,7868617
"117","42121329540000",2073356.964,541393.3458,2017-06-01,229731,39360016,40070952,7593200
"118","42121329540000",2073356.964,541393.3458,2017-07-01,225545,39585561,40070952,8034023
"119","42121329540000",2073356.964,541393.3458,2017-08-01,255264,39840825,40070952,8259439
"120","42121329540000",2073356.964,541393.3458,2017-09-01,230127,40070952,40070952,7833970
"121","42221309830000",1950025.981,244444.3147,2005-02-01,66983,66983,30468061,66983
"122","42221309830000",1950025.981,244444.3147,2005-03-01,160323,227306,30468061,418563
"123","42221309830000",1950025.981,244444.3147,2005-04-01,163587,390893,30468061,435127
"124","42221309830000",1950025.981,244444.3147,2005-05-01,131657,522550,30468061,464117
"125","42221309830000",1950025.981,244444.3147,2005-06-01,115936,638486,30468061,639936
"126","42221309830000",1950025.981,244444.3147,2005-07-01,133619,772105,30468061,822800
"127","42221309830000",1950025.981,244444.3147,2005-08-01,163850,935955,30468061,897133
"128","42221309830000",1950025.981,244444.3147,2005-09-01,169089,1105044,30468061,960193
"129","42221309830000",1950025.981,244444.3147,2005-10-01,221867,1326911,30468061,1037267
"130","42221309830000",1950025.981,244444.3147,2005-11-01,251843,1578754,30468061,1075049
"131","42221309830000",1950025.981,244444.3147,2005-12-01,292279,1871033,30468061,1200947
"132","42221309830000",1950025.981,244444.3147,2006-01-01,222484,2093517,30468061,1350182
"133","42221309830000",1950025.981,244444.3147,2006-02-01,243338,2336855,30468061,1472478
"134","42221309830000",1950025.981,244444.3147,2006-03-01,296457,2633312,30468061,1848901
"135","42221309830000",1950025.981,244444.3147,2006-04-01,321233,2954545,30468061,1923527
"136","42221309830000",1950025.981,244444.3147,2006-05-01,300567,3255112,30468061,2207406
"137","42221309830000",1950025.981,244444.3147,2006-06-01,265681,3520793,30468061,1973653
"138","42221309830000",1950025.981,244444.3147,2006-07-01,288136,3808929,30468061,2021893
"139","42221309830000",1950025.981,244444.3147,2006-08-01,246858,4055787,30468061,2512715
"140","42221309830000",1950025.981,244444.3147,2006-09-01,119093,4174880,30468061,2773616
"141","42221309830000",1950025.981,244444.3147,2006-10-01,226154,4401034,30468061,3124548
"142","42221309830000",1950025.981,244444.3147,2006-11-01,67866,4468900,30468061,3240926
"143","42221309830000",1950025.981,244444.3147,2006-12-01,134691,4603591,30468061,4484941
"144","42221309830000",1950025.981,244444.3147,2007-01-01,189650,4793241,30468061,4380773
"145","42221309830000",1950025.981,244444.3147,2007-02-01,129943,4923184,30468061,4175393
"146","42221309830000",1950025.981,244444.3147,2007-03-01,46218,4969402,30468061,4620840
"147","42221309830000",1950025.981,244444.3147,2007-04-01,113275,5082677,30468061,4876542
"148","42221309830000",1950025.981,244444.3147,2007-05-01,167885,5250562,30468061,5347071
"149","42221309830000",1950025.981,244444.3147,2007-07-01,2760,5253322,30468061,5639953
"150","42221309830000",1950025.981,244444.3147,2007-08-01,65382,5318704,30468061,5967755
"151","42221309830000",1950025.981,244444.3147,2007-09-01,17879,5336583,30468061,5629384
"152","42221309830000",1950025.981,244444.3147,2007-10-01,44339,5380922,30468061,6483309
"153","42221309830000",1950025.981,244444.3147,2007-11-01,84247,5465169,30468061,6157035
"154","42221309830000",1950025.981,244444.3147,2007-12-01,59790,5524959,30468061,5777613
"155","42221309830000",1950025.981,244444.3147,2008-01-01,155978,5680937,30468061,6452815
"156","42221309830000",1950025.981,244444.3147,2008-02-01,146279,5827216,30468061,7775520
"157","42221309830000",1950025.981,244444.3147,2008-03-01,59781,5886997,30468061,9152519
"158","42221309830000",1950025.981,244444.3147,2008-04-01,137776,6024773,30468061,8881211
"159","42221309830000",1950025.981,244444.3147,2008-05-01,120830,6145603,30468061,9790992
"160","42221309830000",1950025.981,244444.3147,2008-07-01,117123,6262726,30468061,9342850
"161","42221309830000",1950025.981,244444.3147,2008-08-01,317235,6579961,30468061,9977335
"162","42221309830000",1950025.981,244444.3147,2008-09-01,235802,6815763,30468061,9513587
"163","42221309830000",1950025.981,244444.3147,2008-10-01,111076,6926839,30468061,9729575
"164","42221309830000",1950025.981,244444.3147,2008-11-01,190995,7117834,30468061,10178583
"165","42221309830000",1950025.981,244444.3147,2008-12-01,246647,7364481,30468061,9857864
"166","42221309830000",1950025.981,244444.3147,2009-01-01,268243,7632724,30468061,9714975
"167","42221309830000",1950025.981,244444.3147,2009-02-01,327092,7959816,30468061,9563848
"168","42221309830000",1950025.981,244444.3147,2009-03-01,357402,8317218,30468061,10011008
"169","42221309830000",1950025.981,244444.3147,2009-04-01,345881,8663099,30468061,8817835
"170","42221309830000",1950025.981,244444.3147,2009-05-01,369628,9032727,30468061,9222275
"171","42221309830000",1950025.981,244444.3147,2009-06-01,389345,9422072,30468061,8823798
"172","42221309830000",1950025.981,244444.3147,2009-07-01,425170,9847242,30468061,9681047
"173","42221309830000",1950025.981,244444.3147,2009-08-01,413136,10260378,30468061,10148823
"174","42221309830000",1950025.981,244444.3147,2009-09-01,318906,10579284,30468061,9880092
"175","42221309830000",1950025.981,244444.3147,2009-10-01,313017,10892301,30468061,10866851
"176","42221309830000",1950025.981,244444.3147,2009-11-01,82070,10974371,30468061,10107974
"177","42221309830000",1950025.981,244444.3147,2009-12-01,249678,11224049,30468061,10176315
"178","42221309830000",1950025.981,244444.3147,2010-01-01,325272,11549321,30468061,10900701
"179","42221309830000",1950025.981,244444.3147,2010-02-01,332845,11882166,30468061,10320596
"180","42221309830000",1950025.981,244444.3147,2010-03-01,412281,12294447,30468061,12054256
"181","42221309830000",1950025.981,244444.3147,2010-04-01,352097,12646544,30468061,11657482
"182","42221309830000",1950025.981,244444.3147,2010-05-01,389074,13035618,30468061,12361540
"183","42221309830000",1950025.981,244444.3147,2010-06-01,387989,13423607,30468061,11806317
"184","42221309830000",1950025.981,244444.3147,2010-07-01,423374,13846981,30468061,13014429
"185","42221309830000",1950025.981,244444.3147,2010-08-01,432322,14279303,30468061,12894731
"186","42221309830000",1950025.981,244444.3147,2010-09-01,404415,14683718,30468061,13014299
"187","42221309830000",1950025.981,244444.3147,2010-10-01,463780,15147498,30468061,11689154
"188","42221309830000",1950025.981,244444.3147,2010-11-01,358229,15505727,30468061,11954124
"189","42221309830000",1950025.981,244444.3147,2010-12-01,293960,15799687,30468061,12386935
"190","42221309830000",1950025.981,244444.3147,2011-01-01,310943,16110630,30468061,12491622
"191","42221309830000",1950025.981,244444.3147,2011-02-01,317133,16427763,30468061,10744516
"192","42221309830000",1950025.981,244444.3147,2011-03-01,460527,16888290,30468061,13585658
"193","42221309830000",1950025.981,244444.3147,2011-04-01,435373,17323663,30468061,13823700
"194","42221309830000",1950025.981,244444.3147,2011-05-01,397185,17720848,30468061,14893483
"195","42221309830000",1950025.981,244444.3147,2011-06-01,240765,17961613,30468061,13536023
"196","42221309830000",1950025.981,244444.3147,2011-07-01,355529,18317142,30468061,14060435
"197","42221309830000",1950025.981,244444.3147,2011-08-01,326823,18643965,30468061,13865713
"198","42221309830000",1950025.981,244444.3147,2011-09-01,353087,18997052,30468061,13575950
"199","42221309830000",1950025.981,244444.3147,2011-10-01,258508,19255560,30468061,14224672
"200","42221309830000",1950025.981,244444.3147,2011-11-01,239137,19494697,30468061,14289379
"201","42221309830000",1950025.981,244444.3147,2011-12-01,278595,19773292,30468061,14301497
"202","42221309830000",1950025.981,244444.3147,2012-01-01,219736,19993028,30468061,14393197
"203","42221309830000",1950025.981,244444.3147,2012-02-01,181229,20174257,30468061,13261820
"204","42221309830000",1950025.981,244444.3147,2012-03-01,199659,20373916,30468061,14719295
"205","42221309830000",1950025.981,244444.3147,2012-04-01,187139,20561055,30468061,13422939
"206","42221309830000",1950025.981,244444.3147,2012-05-01,182093,20743148,30468061,13619470
"207","42221309830000",1950025.981,244444.3147,2012-06-01,171880,20915028,30468061,12965656
"208","42221309830000",1950025.981,244444.3147,2012-07-01,188677,21103705,30468061,13735215
"209","42221309830000",1950025.981,244444.3147,2012-08-01,189015,21292720,30468061,13116786
"210","42221309830000",1950025.981,244444.3147,2012-09-01,231782,21524502,30468061,12508392
"211","42221309830000",1950025.981,244444.3147,2012-10-01,189722,21714224,30468061,12829987
"212","42221309830000",1950025.981,244444.3147,2012-11-01,166921,21881145,30468061,11811242
"213","42221309830000",1950025.981,244444.3147,2012-12-01,153238,22034383,30468061,12077125
"214","42221309830000",1950025.981,244444.3147,2013-01-01,137357,22171740,30468061,12754328
"215","42221309830000",1950025.981,244444.3147,2013-02-01,123419,22295159,30468061,11309584
"216","42221309830000",1950025.981,244444.3147,2013-03-01,132216,22427375,30468061,12445227
"217","42221309830000",1950025.981,244444.3147,2013-04-01,136818,22564193,30468061,11899338
"218","42221309830000",1950025.981,244444.3147,2013-05-01,142673,22706866,30468061,11963242
"219","42221309830000",1950025.981,244444.3147,2013-06-01,108477,22815343,30468061,11514151
"220","42221309830000",1950025.981,244444.3147,2013-07-01,101538,22916881,30468061,12334827
"221","42221309830000",1950025.981,244444.3147,2013-08-01,105540,23022421,30468061,12036527
"222","42221309830000",1950025.981,244444.3147,2013-09-01,111292,23133713,30468061,11831621
"223","42221309830000",1950025.981,244444.3147,2013-10-01,116944,23250657,30468061,11912081
"224","42221309830000",1950025.981,244444.3147,2013-11-01,184317,23434974,30468061,11402351
"225","42221309830000",1950025.981,244444.3147,2013-12-01,228042,23663016,30468061,10800800
"226","42221309830000",1950025.981,244444.3147,2014-01-01,312289,23975305,30468061,11386084
"227","42221309830000",1950025.981,244444.3147,2014-02-01,270644,24245949,30468061,9936683
"228","42221309830000",1950025.981,244444.3147,2014-03-01,299163,24545112,30468061,12046987
"229","42221309830000",1950025.981,244444.3147,2014-04-01,199994,24745106,30468061,11738869
"230","42221309830000",1950025.981,244444.3147,2014-05-01,210476,24955582,30468061,12165041
"231","42221309830000",1950025.981,244444.3147,2014-06-01,206598,25162180,30468061,11720072
"232","42221309830000",1950025.981,244444.3147,2014-07-01,209930,25372110,30468061,11632955
"233","42221309830000",1950025.981,244444.3147,2014-08-01,210645,25582755,30468061,11280396
"234","42221309830000",1950025.981,244444.3147,2014-09-01,191848,25774603,30468061,10707843
"235","42221309830000",1950025.981,244444.3147,2014-10-01,177686,25952289,30468061,11154961
"236","42221309830000",1950025.981,244444.3147,2014-11-01,175251,26127540,30468061,11006198
"237","42221309830000",1950025.981,244444.3147,2014-12-01,171803,26299343,30468061,11175048
"238","42221309830000",1950025.981,244444.3147,2015-01-01,151292,26450635,30468061,11188192
"239","42221309830000",1950025.981,244444.3147,2015-02-01,129629,26580264,30468061,9285348
"240","42221309830000",1950025.981,244444.3147,2015-03-01,299163,26879427,30468061,11132951
"241","42221309830000",1950025.981,244444.3147,2015-04-01,74994,26954421,30468061,10228970
"242","42221309830000",1950025.981,244444.3147,2015-05-01,81278,27035699,30468061,10731832
"243","42221309830000",1950025.981,244444.3147,2015-06-01,71065,27106764,30468061,10019178
"244","42221309830000",1950025.981,244444.3147,2015-07-01,61853,27168617,30468061,9556838
"245","42221309830000",1950025.981,244444.3147,2015-08-01,66955,27235572,30468061,9046352
"246","42221309830000",1950025.981,244444.3147,2015-09-01,64654,27300226,30468061,8436833
"247","42221309830000",1950025.981,244444.3147,2015-10-01,66692,27366918,30468061,8702949
"248","42221309830000",1950025.981,244444.3147,2015-11-01,68373,27435291,30468061,8702391
"249","42221309830000",1950025.981,244444.3147,2015-12-01,50636,27485927,30468061,8797617
"250","42221309830000",1950025.981,244444.3147,2016-01-01,52819,27538746,30468061,8785697
"251","42221309830000",1950025.981,244444.3147,2016-02-01,52007,27590753,30468061,8098391
"252","42221309830000",1950025.981,244444.3147,2016-03-01,52397,27643150,30468061,8313445
"253","42221309830000",1950025.981,244444.3147,2016-04-01,57339,27700489,30468061,8067410
"254","42221309830000",1950025.981,244444.3147,2016-05-01,137000,27837489,30468061,8687363
"255","42221309830000",1950025.981,244444.3147,2016-06-01,248093,28085582,30468061,8474598
"256","42221309830000",1950025.981,244444.3147,2016-07-01,301114,28386696,30468061,8474294
"257","42221309830000",1950025.981,244444.3147,2016-08-01,185138,28571834,30468061,8424724
"258","42221309830000",1950025.981,244444.3147,2016-09-01,185242,28757076,30468061,7958587
"259","42221309830000",1950025.981,244444.3147,2016-10-01,163809,28920885,30468061,7328643
"260","42221309830000",1950025.981,244444.3147,2016-11-01,186009,29106894,30468061,7108192
"261","42221309830000",1950025.981,244444.3147,2016-12-01,202265,29309159,30468061,7206177
"262","42221309830000",1950025.981,244444.3147,2017-01-01,187407,29496566,30468061,8191419
"263","42221309830000",1950025.981,244444.3147,2017-02-01,148251,29644817,30468061,7284679
"264","42221309830000",1950025.981,244444.3147,2017-03-01,195152,29839969,30468061,7793859
"265","42221309830000",1950025.981,244444.3147,2017-04-01,163448,30003417,30468061,7558837
"266","42221309830000",1950025.981,244444.3147,2017-05-01,1827,30005244,30468061,7868617
"267","42221309830000",1950025.981,244444.3147,2017-07-01,102961,30108205,30468061,8034023
"268","42221309830000",1950025.981,244444.3147,2017-08-01,191300,30299505,30468061,8259439
"269","42221309830000",1950025.981,244444.3147,2017-09-01,168556,30468061,30468061,7833970
"270","42221311090000",1889924.386,237269.3924,2007-02-01,8320,8320,25341123,4175393
"271","42221311090000",1889924.386,237269.3924,2007-03-01,36530,44850,25341123,4620840
"272","42221311090000",1889924.386,237269.3924,2007-04-01,40170,85020,25341123,4876542
"273","42221311090000",1889924.386,237269.3924,2007-05-01,65910,150930,25341123,5347071
"274","42221311090000",1889924.386,237269.3924,2007-06-01,116792,267722,25341123,5055569
"275","42221311090000",1889924.386,237269.3924,2007-07-01,191616,459338,25341123,5639953
"276","42221311090000",1889924.386,237269.3924,2007-08-01,230584,689922,25341123,5967755
"277","42221311090000",1889924.386,237269.3924,2007-09-01,336290,1026212,25341123,5629384
"278","42221311090000",1889924.386,237269.3924,2007-10-01,329437,1355649,25341123,6483309
"279","42221311090000",1889924.386,237269.3924,2007-11-01,311543,1667192,25341123,6157035
"280","42221311090000",1889924.386,237269.3924,2007-12-01,294597,1961789,25341123,5777613
"281","42221311090000",1889924.386,237269.3924,2008-01-01,335332,2297121,25341123,6452815
"282","42221311090000",1889924.386,237269.3924,2008-02-01,233728,2530849,25341123,7775520
"283","42221311090000",1889924.386,237269.3924,2008-03-01,186328,2717177,25341123,9152519
"284","42221311090000",1889924.386,237269.3924,2008-04-01,84798,2801975,25341123,8881211
"285","42221311090000",1889924.386,237269.3924,2008-05-01,70679,2872654,25341123,9790992
"286","42221311090000",1889924.386,237269.3924,2008-06-01,79306,2951960,25341123,9489076
"287","42221311090000",1889924.386,237269.3924,2008-07-01,14018,2965978,25341123,9342850
"288","42221311090000",1889924.386,237269.3924,2008-08-01,51833,3017811,25341123,9977335
"289","42221311090000",1889924.386,237269.3924,2008-09-01,58187,3075998,25341123,9513587
"290","42221311090000",1889924.386,237269.3924,2008-10-01,85923,3161921,25341123,9729575
"291","42221311090000",1889924.386,237269.3924,2008-11-01,185372,3347293,25341123,10178583
"292","42221311090000",1889924.386,237269.3924,2008-12-01,26385,3373678,25341123,9857864
"293","42221311090000",1889924.386,237269.3924,2009-01-01,15230,3388908,25341123,9714975
"294","42221311090000",1889924.386,237269.3924,2009-02-01,23466,3412374,25341123,9563848
"295","42221311090000",1889924.386,237269.3924,2009-03-01,21971,3434345,25341123,10011008
"296","42221311090000",1889924.386,237269.3924,2009-04-01,34788,3469133,25341123,8817835
"297","42221311090000",1889924.386,237269.3924,2009-05-01,270520,3739653,25341123,9222275
"298","42221311090000",1889924.386,237269.3924,2009-06-01,276866,4016519,25341123,8823798
"299","42221311090000",1889924.386,237269.3924,2009-07-01,202655,4219174,25341123,9681047
"300","42221311090000",1889924.386,237269.3924,2009-08-01,550472,4769646,25341123,10148823
"301","42221311090000",1889924.386,237269.3924,2009-09-01,465460,5235106,25341123,9880092
"302","42221311090000",1889924.386,237269.3924,2009-10-01,246502,5481608,25341123,10866851
"303","42221311090000",1889924.386,237269.3924,2009-11-01,428658,5910266,25341123,10107974
"304","42221311090000",1889924.386,237269.3924,2009-12-01,260876,6171142,25341123,10176315
"305","42221311090000",1889924.386,237269.3924,2010-01-01,301844,6472986,25341123,10900701
"306","42221311090000",1889924.386,237269.3924,2010-02-01,428931,6901917,25341123,10320596
"307","42221311090000",1889924.386,237269.3924,2010-03-01,356190,7258107,25341123,12054256
"308","42221311090000",1889924.386,237269.3924,2010-04-01,360307,7618414,25341123,11657482
"309","42221311090000",1889924.386,237269.3924,2010-05-01,485745,8104159,25341123,12361540
"310","42221311090000",1889924.386,237269.3924,2010-06-01,406175,8510334,25341123,11806317
"311","42221311090000",1889924.386,237269.3924,2010-07-01,438867,8949201,25341123,13014429
"312","42221311090000",1889924.386,237269.3924,2010-08-01,391419,9340620,25341123,12894731
"313","42221311090000",1889924.386,237269.3924,2010-09-01,410371,9750991,25341123,13014299
"314","42221311090000",1889924.386,237269.3924,2010-10-01,338545,10089536,25341123,11689154
"315","42221311090000",1889924.386,237269.3924,2010-11-01,354252,10443788,25341123,11954124
"316","42221311090000",1889924.386,237269.3924,2010-12-01,390604,10834392,25341123,12386935
"317","42221311090000",1889924.386,237269.3924,2011-01-01,448451,11282843,25341123,12491622
"318","42221311090000",1889924.386,237269.3924,2011-02-01,322053,11604896,25341123,10744516
"319","42221311090000",1889924.386,237269.3924,2011-03-01,532373,12137269,25341123,13585658
"320","42221311090000",1889924.386,237269.3924,2011-04-01,453665,12590934,25341123,13823700
"321","42221311090000",1889924.386,237269.3924,2011-05-01,377381,12968315,25341123,14893483
"322","42221311090000",1889924.386,237269.3924,2011-06-01,353142,13321457,25341123,13536023
"323","42221311090000",1889924.386,237269.3924,2011-07-01,325786,13647243,25341123,14060435
"324","42221311090000",1889924.386,237269.3924,2011-08-01,353105,14000348,25341123,13865713
"325","42221311090000",1889924.386,237269.3924,2011-09-01,320213,14320561,25341123,13575950
"326","42221311090000",1889924.386,237269.3924,2011-10-01,426490,14747051,25341123,14224672
"327","42221311090000",1889924.386,237269.3924,2011-11-01,459327,15206378,25341123,14289379
"328","42221311090000",1889924.386,237269.3924,2011-12-01,462262,15668640,25341123,14301497
"329","42221311090000",1889924.386,237269.3924,2012-01-01,414731,16083371,25341123,14393197
"330","42221311090000",1889924.386,237269.3924,2012-02-01,303737,16387108,25341123,13261820
"331","42221311090000",1889924.386,237269.3924,2012-03-01,434490,16821598,25341123,14719295
"332","42221311090000",1889924.386,237269.3924,2012-04-01,456028,17277626,25341123,13422939
"333","42221311090000",1889924.386,237269.3924,2012-05-01,359429,17637055,25341123,13619470
"334","42221311090000",1889924.386,237269.3924,2012-06-01,222597,17859652,25341123,12965656
"335","42221311090000",1889924.386,237269.3924,2012-07-01,338338,18197990,25341123,13735215
"336","42221311090000",1889924.386,237269.3924,2012-08-01,240501,18438491,25341123,13116786
"337","42221311090000",1889924.386,237269.3924,2012-09-01,225450,18663941,25341123,12508392
"338","42221311090000",1889924.386,237269.3924,2012-10-01,209413,18873354,25341123,12829987
"339","42221311090000",1889924.386,237269.3924,2012-11-01,190665,19064019,25341123,11811242
"340","42221311090000",1889924.386,237269.3924,2012-12-01,163575,19227594,25341123,12077125
"341","42221311090000",1889924.386,237269.3924,2013-01-01,178696,19406290,25341123,12754328
"342","42221311090000",1889924.386,237269.3924,2013-02-01,148017,19554307,25341123,11309584
"343","42221311090000",1889924.386,237269.3924,2013-03-01,161206,19715513,25341123,12445227
"344","42221311090000",1889924.386,237269.3924,2013-04-01,169290,19884803,25341123,11899338
"345","42221311090000",1889924.386,237269.3924,2013-05-01,109210,19994013,25341123,11963242
"346","42221311090000",1889924.386,237269.3924,2013-06-01,94910,20088923,25341123,11514151
"347","42221311090000",1889924.386,237269.3924,2013-07-01,106420,20195343,25341123,12334827
"348","42221311090000",1889924.386,237269.3924,2013-08-01,109255,20304598,25341123,12036527
"349","42221311090000",1889924.386,237269.3924,2013-09-01,121987,20426585,25341123,11831621
"350","42221311090000",1889924.386,237269.3924,2013-10-01,100320,20526905,25341123,11912081
"351","42221311090000",1889924.386,237269.3924,2013-11-01,154019,20680924,25341123,11402351
"352","42221311090000",1889924.386,237269.3924,2013-12-01,184013,20864937,25341123,10800800
"353","42221311090000",1889924.386,237269.3924,2014-01-01,271043,21135980,25341123,11386084
"354","42221311090000",1889924.386,237269.3924,2014-02-01,226447,21362427,25341123,9936683
"355","42221311090000",1889924.386,237269.3924,2014-03-01,210458,21572885,25341123,12046987
"356","42221311090000",1889924.386,237269.3924,2014-04-01,192196,21765081,25341123,11738869
"357","42221311090000",1889924.386,237269.3924,2014-05-01,235122,22000203,25341123,12165041
"358","42221311090000",1889924.386,237269.3924,2014-06-01,198942,22199145,25341123,11720072
"359","42221311090000",1889924.386,237269.3924,2014-07-01,192849,22391994,25341123,11632955
"360","42221311090000",1889924.386,237269.3924,2014-08-01,184627,22576621,25341123,11280396
"361","42221311090000",1889924.386,237269.3924,2014-09-01,184225,22760846,25341123,10707843
"362","42221311090000",1889924.386,237269.3924,2014-10-01,185789,22946635,25341123,11154961
"363","42221311090000",1889924.386,237269.3924,2014-11-01,97898,23044533,25341123,11006198
"364","42221311090000",1889924.386,237269.3924,2014-12-01,89882,23134415,25341123,11175048
"365","42221311090000",1889924.386,237269.3924,2015-01-01,98820,23233235,25341123,11188192
"366","42221311090000",1889924.386,237269.3924,2015-02-01,73102,23306337,25341123,9285348
"367","42221311090000",1889924.386,237269.3924,2015-03-01,96502,23402839,25341123,11132951
"368","42221311090000",1889924.386,237269.3924,2015-04-01,83010,23485849,25341123,10228970
"369","42221311090000",1889924.386,237269.3924,2015-05-01,58515,23544364,25341123,10731832
"370","42221311090000",1889924.386,237269.3924,2015-06-01,48747,23593111,25341123,10019178
"371","42221311090000",1889924.386,237269.3924,2015-07-01,54872,23647983,25341123,9556838
"372","42221311090000",1889924.386,237269.3924,2015-08-01,184627,23832610,25341123,9046352
"373","42221311090000",1889924.386,237269.3924,2015-09-01,50265,23882875,25341123,8436833
"374","42221311090000",1889924.386,237269.3924,2015-10-01,48077,23930952,25341123,8702949
"375","42221311090000",1889924.386,237269.3924,2015-11-01,51159,23982111,25341123,8702391
"376","42221311090000",1889924.386,237269.3924,2015-12-01,47030,24029141,25341123,8797617
"377","42221311090000",1889924.386,237269.3924,2016-01-01,41076,24070217,25341123,8785697
"378","42221311090000",1889924.386,237269.3924,2016-02-01,30860,24101077,25341123,8098391
"379","42221311090000",1889924.386,237269.3924,2016-03-01,58129,24159206,25341123,8313445
"380","42221311090000",1889924.386,237269.3924,2016-04-01,33585,24192791,25341123,8067410
"381","42221311090000",1889924.386,237269.3924,2016-05-01,58600,24251391,25341123,8687363
"382","42221311090000",1889924.386,237269.3924,2016-06-01,35631,24287022,25341123,8474598
"383","42221311090000",1889924.386,237269.3924,2016-07-01,62293,24349315,25341123,8474294
"384","42221311090000",1889924.386,237269.3924,2016-08-01,61012,24410327,25341123,8424724
"385","42221311090000",1889924.386,237269.3924,2016-09-01,49728,24460055,25341123,7958587
"386","42221311090000",1889924.386,237269.3924,2016-10-01,52492,24512547,25341123,7328643
"387","42221311090000",1889924.386,237269.3924,2016-11-01,81824,24594371,25341123,7108192
"388","42221311090000",1889924.386,237269.3924,2016-12-01,76161,24670532,25341123,7206177
"389","42221311090000",1889924.386,237269.3924,2017-01-01,68346,24738878,25341123,8191419
"390","42221311090000",1889924.386,237269.3924,2017-02-01,66337,24805215,25341123,7284679
"391","42221311090000",1889924.386,237269.3924,2017-03-01,60606,24865821,25341123,7793859
"392","42221311090000",1889924.386,237269.3924,2017-04-01,62692,24928513,25341123,7558837
"393","42221311090000",1889924.386,237269.3924,2017-05-01,74241,25002754,25341123,7868617
"394","42221311090000",1889924.386,237269.3924,2017-06-01,76699,25079453,25341123,7593200
"395","42221311090000",1889924.386,237269.3924,2017-07-01,87784,25167237,25341123,8034023
"396","42221311090000",1889924.386,237269.3924,2017-08-01,83478,25250715,25341123,8259439
"397","42221311090000",1889924.386,237269.3924,2017-09-01,90408,25341123,25341123,7833970
"398","42251302190000",2030739.997,265167.3521,2005-10-01,6340,6340,53475085,1037267
"399","42251302190000",2030739.997,265167.3521,2006-01-01,15640,21980,53475085,1350182
"400","42251302190000",2030739.997,265167.3521,2006-02-01,188661,210641,53475085,1472478
"401","42251302190000",2030739.997,265167.3521,2006-03-01,323031,533672,53475085,1848901
"402","42251302190000",2030739.997,265167.3521,2006-04-01,394064,927736,53475085,1923527
"403","42251302190000",2030739.997,265167.3521,2006-05-01,326836,1254572,53475085,2207406
"404","42251302190000",2030739.997,265167.3521,2006-06-01,244699,1499271,53475085,1973653
"405","42251302190000",2030739.997,265167.3521,2006-07-01,203801,1703072,53475085,2021893
"406","42251302190000",2030739.997,265167.3521,2006-08-01,269795,1972867,53475085,2512715
"407","42251302190000",2030739.997,265167.3521,2006-09-01,223875,2196742,53475085,2773616
"408","42251302190000",2030739.997,265167.3521,2006-10-01,344944,2541686,53475085,3124548
"409","42251302190000",2030739.997,265167.3521,2006-11-01,205205,2746891,53475085,3240926
"410","42251302190000",2030739.997,265167.3521,2006-12-01,429164,3176055,53475085,4484941
"411","42251302190000",2030739.997,265167.3521,2007-01-01,371879,3547934,53475085,4380773
"412","42251302190000",2030739.997,265167.3521,2007-02-01,390182,3938116,53475085,4175393
"413","42251302190000",2030739.997,265167.3521,2007-03-01,430385,4368501,53475085,4620840
"414","42251302190000",2030739.997,265167.3521,2007-04-01,470588,4839089,53475085,4876542
"415","42251302190000",2030739.997,265167.3521,2007-05-01,494414,5333503,53475085,5347071
"416","42251302190000",2030739.997,265167.3521,2007-06-01,496870,5830373,53475085,5055569
"417","42251302190000",2030739.997,265167.3521,2007-07-01,500233,6330606,53475085,5639953
"418","42251302190000",2030739.997,265167.3521,2007-08-01,513473,6844079,53475085,5967755
"419","42251302190000",2030739.997,265167.3521,2007-09-01,459740,7303819,53475085,5629384
"420","42251302190000",2030739.997,265167.3521,2007-10-01,487410,7791229,53475085,6483309
"421","42251302190000",2030739.997,265167.3521,2007-11-01,467923,8259152,53475085,6157035
"422","42251302190000",2030739.997,265167.3521,2007-12-01,465576,8724728,53475085,5777613
"423","42251302190000",2030739.997,265167.3521,2008-01-01,451808,9176536,53475085,6452815
"424","42251302190000",2030739.997,265167.3521,2008-02-01,399192,9575728,53475085,7775520
"425","42251302190000",2030739.997,265167.3521,2008-03-01,481360,10057088,53475085,9152519
"426","42251302190000",2030739.997,265167.3521,2008-04-01,475940,10533028,53475085,8881211
"427","42251302190000",2030739.997,265167.3521,2008-05-01,475538,11008566,53475085,9790992
"428","42251302190000",2030739.997,265167.3521,2008-06-01,451111,11459677,53475085,9489076
"429","42251302190000",2030739.997,265167.3521,2008-07-01,474260,11933937,53475085,9342850
"430","42251302190000",2030739.997,265167.3521,2008-08-01,445630,12379567,53475085,9977335
"431","42251302190000",2030739.997,265167.3521,2008-09-01,400290,12779857,53475085,9513587
"432","42251302190000",2030739.997,265167.3521,2008-10-01,443429,13223286,53475085,9729575
"433","42251302190000",2030739.997,265167.3521,2008-11-01,433616,13656902,53475085,10178583
"434","42251302190000",2030739.997,265167.3521,2008-12-01,485761,14142663,53475085,9857864
"435","42251302190000",2030739.997,265167.3521,2009-01-01,474548,14617211,53475085,9714975
"436","42251302190000",2030739.997,265167.3521,2009-02-01,432293,15049504,53475085,9563848
"437","42251302190000",2030739.997,265167.3521,2009-03-01,449361,15498865,53475085,10011008
"438","42251302190000",2030739.997,265167.3521,2009-04-01,418778,15917643,53475085,8817835
"439","42251302190000",2030739.997,265167.3521,2009-05-01,483573,16401216,53475085,9222275
"440","42251302190000",2030739.997,265167.3521,2009-06-01,457899,16859115,53475085,8823798
"441","42251302190000",2030739.997,265167.3521,2009-07-01,460306,17319421,53475085,9681047
"442","42251302190000",2030739.997,265167.3521,2009-08-01,467648,17787069,53475085,10148823
"443","42251302190000",2030739.997,265167.3521,2009-09-01,446415,18233484,53475085,9880092
"444","42251302190000",2030739.997,265167.3521,2009-10-01,456630,18690114,53475085,10866851
"445","42251302190000",2030739.997,265167.3521,2009-11-01,467824,19157938,53475085,10107974
"446","42251302190000",2030739.997,265167.3521,2009-12-01,520489,19678427,53475085,10176315
"447","42251302190000",2030739.997,265167.3521,2010-01-01,523981,20202408,53475085,10900701
"448","42251302190000",2030739.997,265167.3521,2010-02-01,450737,20653145,53475085,10320596
"449","42251302190000",2030739.997,265167.3521,2010-03-01,531676,21184821,53475085,12054256
"450","42251302190000",2030739.997,265167.3521,2010-04-01,515429,21700250,53475085,11657482
"451","42251302190000",2030739.997,265167.3521,2010-05-01,535016,22235266,53475085,12361540
"452","42251302190000",2030739.997,265167.3521,2010-06-01,506824,22742090,53475085,11806317
"453","42251302190000",2030739.997,265167.3521,2010-07-01,520601,23262691,53475085,13014429
"454","42251302190000",2030739.997,265167.3521,2010-08-01,528829,23791520,53475085,12894731
"455","42251302190000",2030739.997,265167.3521,2010-09-01,493203,24284723,53475085,13014299
"456","42251302190000",2030739.997,265167.3521,2010-10-01,508334,24793057,53475085,11689154
"457","42251302190000",2030739.997,265167.3521,2010-11-01,459533,25252590,53475085,11954124
"458","42251302190000",2030739.997,265167.3521,2010-12-01,390632,25643222,53475085,12386935
"459","42251302190000",2030739.997,265167.3521,2011-01-01,434284,26077506,53475085,12491622
"460","42251302190000",2030739.997,265167.3521,2011-02-01,382523,26460029,53475085,10744516
"461","42251302190000",2030739.997,265167.3521,2011-03-01,479991,26940020,53475085,13585658
"462","42251302190000",2030739.997,265167.3521,2011-04-01,376448,27316468,53475085,13823700
"463","42251302190000",2030739.997,265167.3521,2011-05-01,436399,27752867,53475085,14893483
"464","42251302190000",2030739.997,265167.3521,2011-06-01,386155,28139022,53475085,13536023
"465","42251302190000",2030739.997,265167.3521,2011-07-01,376622,28515644,53475085,14060435
"466","42251302190000",2030739.997,265167.3521,2011-08-01,325386,28841030,53475085,13865713
"467","42251302190000",2030739.997,265167.3521,2011-09-01,350471,29191501,53475085,13575950
"468","42251302190000",2030739.997,265167.3521,2011-10-01,266616,29458117,53475085,14224672
"469","42251302190000",2030739.997,265167.3521,2011-11-01,439577,29897694,53475085,14289379
"470","42251302190000",2030739.997,265167.3521,2011-12-01,440908,30338602,53475085,14301497
"471","42251302190000",2030739.997,265167.3521,2012-01-01,431755,30770357,53475085,14393197
"472","42251302190000",2030739.997,265167.3521,2012-02-01,400240,31170597,53475085,13261820
"473","42251302190000",2030739.997,265167.3521,2012-03-01,430180,31600777,53475085,14719295
"474","42251302190000",2030739.997,265167.3521,2012-04-01,375302,31976079,53475085,13422939
"475","42251302190000",2030739.997,265167.3521,2012-05-01,427211,32403290,53475085,13619470
"476","42251302190000",2030739.997,265167.3521,2012-06-01,412462,32815752,53475085,12965656
"477","42251302190000",2030739.997,265167.3521,2012-07-01,412165,33227917,53475085,13735215
"478","42251302190000",2030739.997,265167.3521,2012-08-01,412252,33640169,53475085,13116786
"479","42251302190000",2030739.997,265167.3521,2012-09-01,390588,34030757,53475085,12508392
"480","42251302190000",2030739.997,265167.3521,2012-10-01,368482,34399239,53475085,12829987
"481","42251302190000",2030739.997,265167.3521,2012-11-01,344469,34743708,53475085,11811242
"482","42251302190000",2030739.997,265167.3521,2012-12-01,248621,34992329,53475085,12077125
"483","42251302190000",2030739.997,265167.3521,2013-01-01,343972,35336301,53475085,12754328
"484","42251302190000",2030739.997,265167.3521,2013-02-01,339672,35675973,53475085,11309584
"485","42251302190000",2030739.997,265167.3521,2013-03-01,283899,35959872,53475085,12445227
"486","42251302190000",2030739.997,265167.3521,2013-04-01,321000,36280872,53475085,11899338
"487","42251302190000",2030739.997,265167.3521,2013-05-01,377167,36658039,53475085,11963242
"488","42251302190000",2030739.997,265167.3521,2013-06-01,376460,37034499,53475085,11514151
"489","42251302190000",2030739.997,265167.3521,2013-07-01,405902,37440401,53475085,12334827
"490","42251302190000",2030739.997,265167.3521,2013-08-01,419453,37859854,53475085,12036527
"491","42251302190000",2030739.997,265167.3521,2013-09-01,386933,38246787,53475085,11831621
"492","42251302190000",2030739.997,265167.3521,2013-10-01,363022,38609809,53475085,11912081
"493","42251302190000",2030739.997,265167.3521,2013-11-01,409001,39018810,53475085,11402351
"494","42251302190000",2030739.997,265167.3521,2013-12-01,371153,39389963,53475085,10800800
"495","42251302190000",2030739.997,265167.3521,2014-01-01,395551,39785514,53475085,11386084
"496","42251302190000",2030739.997,265167.3521,2014-02-01,356472,40141986,53475085,9936683
"497","42251302190000",2030739.997,265167.3521,2014-03-01,442823,40584809,53475085,12046987
"498","42251302190000",2030739.997,265167.3521,2014-04-01,429949,41014758,53475085,11738869
"499","42251302190000",2030739.997,265167.3521,2014-05-01,457197,41471955,53475085,12165041
"500","42251302190000",2030739.997,265167.3521,2014-06-01,430574,41902529,53475085,11720072
"501","42251302190000",2030739.997,265167.3521,2014-07-01,439732,42342261,53475085,11632955
"502","42251302190000",2030739.997,265167.3521,2014-08-01,441751,42784012,53475085,11280396
"503","42251302190000",2030739.997,265167.3521,2014-09-01,323452,43107464,53475085,10707843
"504","42251302190000",2030739.997,265167.3521,2014-10-01,95,43107559,53475085,11154961
"505","42251302190000",2030739.997,265167.3521,2014-11-01,384932,43492491,53475085,11006198
"506","42251302190000",2030739.997,265167.3521,2014-12-01,428778,43921269,53475085,11175048
"507","42251302190000",2030739.997,265167.3521,2015-01-01,412387,44333656,53475085,11188192
"508","42251302190000",2030739.997,265167.3521,2015-02-01,341580,44675236,53475085,9285348
"509","42251302190000",2030739.997,265167.3521,2015-03-01,442823,45118059,53475085,11132951
"510","42251302190000",2030739.997,265167.3521,2015-04-01,326302,45444361,53475085,10228970
"511","42251302190000",2030739.997,265167.3521,2015-05-01,359615,45803976,53475085,10731832
"512","42251302190000",2030739.997,265167.3521,2015-06-01,409592,46213568,53475085,10019178
"513","42251302190000",2030739.997,265167.3521,2015-07-01,264724,46478292,53475085,9556838
"514","42251302190000",2030739.997,265167.3521,2015-08-01,399173,46877465,53475085,9046352
"515","42251302190000",2030739.997,265167.3521,2015-09-01,311062,47188527,53475085,8436833
"516","42251302190000",2030739.997,265167.3521,2015-10-01,336375,47524902,53475085,8702949
"517","42251302190000",2030739.997,265167.3521,2015-11-01,306984,47831886,53475085,8702391
"518","42251302190000",2030739.997,265167.3521,2015-12-01,391146,48223032,53475085,8797617
"519","42251302190000",2030739.997,265167.3521,2016-01-01,439968,48663000,53475085,8785697
"520","42251302190000",2030739.997,265167.3521,2016-02-01,408776,49071776,53475085,8098391
"521","42251302190000",2030739.997,265167.3521,2016-03-01,412871,49484647,53475085,8313445
"522","42251302190000",2030739.997,265167.3521,2016-04-01,279723,49764370,53475085,8067410
"523","42251302190000",2030739.997,265167.3521,2016-05-01,261616,50025986,53475085,8687363
"524","42251302190000",2030739.997,265167.3521,2016-06-01,253749,50279735,53475085,8474598
"525","42251302190000",2030739.997,265167.3521,2016-07-01,228415,50508150,53475085,8474294
"526","42251302190000",2030739.997,265167.3521,2016-08-01,238056,50746206,53475085,8424724
"527","42251302190000",2030739.997,265167.3521,2016-09-01,236663,50982869,53475085,7958587
"528","42251302190000",2030739.997,265167.3521,2016-10-01,250559,51233428,53475085,7328643
"529","42251302190000",2030739.997,265167.3521,2016-11-01,245015,51478443,53475085,7108192
"530","42251302190000",2030739.997,265167.3521,2016-12-01,230896,51709339,53475085,7206177
"531","42251302190000",2030739.997,265167.3521,2017-01-01,248989,51958328,53475085,8191419
"532","42251302190000",2030739.997,265167.3521,2017-02-01,65519,52023847,53475085,7284679
"533","42251302190000",2030739.997,265167.3521,2017-03-01,158259,52182106,53475085,7793859
"534","42251302190000",2030739.997,265167.3521,2017-04-01,218348,52400454,53475085,7558837
"535","42251302190000",2030739.997,265167.3521,2017-05-01,234643,52635097,53475085,7868617
"536","42251302190000",2030739.997,265167.3521,2017-06-01,228289,52863386,53475085,7593200
"537","42251302190000",2030739.997,265167.3521,2017-07-01,213757,53077143,53475085,8034023
"538","42251302190000",2030739.997,265167.3521,2017-08-01,205977,53283120,53475085,8259439
"539","42251302190000",2030739.997,265167.3521,2017-09-01,191965,53475085,53475085,7833970
"540","42251302490000",1986665.559,257428.6265,2005-03-01,258240,258240,60073914,418563
"541","42251302490000",1986665.559,257428.6265,2005-04-01,271540,529780,60073914,435127
"542","42251302490000",1986665.559,257428.6265,2005-05-01,332460,862240,60073914,464117
"543","42251302490000",1986665.559,257428.6265,2005-06-01,389280,1251520,60073914,639936
"544","42251302490000",1986665.559,257428.6265,2005-07-01,461640,1713160,60073914,822800
"545","42251302490000",1986665.559,257428.6265,2005-08-01,505080,2218240,60073914,897133
"546","42251302490000",1986665.559,257428.6265,2005-09-01,499800,2718040,60073914,960193
"547","42251302490000",1986665.559,257428.6265,2005-10-01,563810,3281850,60073914,1037267
"548","42251302490000",1986665.559,257428.6265,2005-11-01,533828,3815678,60073914,1075049
"549","42251302490000",1986665.559,257428.6265,2005-12-01,561389,4377067,60073914,1200947
"550","42251302490000",1986665.559,257428.6265,2006-01-01,635170,5012237,60073914,1350182
"551","42251302490000",1986665.559,257428.6265,2006-02-01,447308,5459545,60073914,1472478
"552","42251302490000",1986665.559,257428.6265,2006-03-01,554382,6013927,60073914,1848901
"553","42251302490000",1986665.559,257428.6265,2006-04-01,528330,6542257,60073914,1923527
"554","42251302490000",1986665.559,257428.6265,2006-05-01,635003,7177260,60073914,2207406
"555","42251302490000",1986665.559,257428.6265,2006-06-01,623760,7801020,60073914,1973653
"556","42251302490000",1986665.559,257428.6265,2006-07-01,503578,8304598,60073914,2021893
"557","42251302490000",1986665.559,257428.6265,2006-08-01,411498,8716096,60073914,2512715
"558","42251302490000",1986665.559,257428.6265,2006-09-01,326292,9042388,60073914,2773616
"559","42251302490000",1986665.559,257428.6265,2006-10-01,368325,9410713,60073914,3124548
"560","42251302490000",1986665.559,257428.6265,2006-11-01,362734,9773447,60073914,3240926
"561","42251302490000",1986665.559,257428.6265,2006-12-01,369405,10142852,60073914,4484941
"562","42251302490000",1986665.559,257428.6265,2007-01-01,307548,10450400,60073914,4380773
"563","42251302490000",1986665.559,257428.6265,2007-02-01,312305,10762705,60073914,4175393
"564","42251302490000",1986665.559,257428.6265,2007-03-01,411721,11174426,60073914,4620840
"565","42251302490000",1986665.559,257428.6265,2007-04-01,444736,11619162,60073914,4876542
"566","42251302490000",1986665.559,257428.6265,2007-05-01,291893,11911055,60073914,5347071
"567","42251302490000",1986665.559,257428.6265,2007-06-01,291416,12202471,60073914,5055569
"568","42251302490000",1986665.559,257428.6265,2007-07-01,275151,12477622,60073914,5639953
"569","42251302490000",1986665.559,257428.6265,2007-08-01,447973,12925595,60073914,5967755
"570","42251302490000",1986665.559,257428.6265,2007-09-01,332972,13258567,60073914,5629384
"571","42251302490000",1986665.559,257428.6265,2007-10-01,393224,13651791,60073914,6483309
"572","42251302490000",1986665.559,257428.6265,2007-11-01,414542,14066333,60073914,6157035
"573","42251302490000",1986665.559,257428.6265,2007-12-01,380665,14446998,60073914,5777613
"574","42251302490000",1986665.559,257428.6265,2008-01-01,400204,14847202,60073914,6452815
"575","42251302490000",1986665.559,257428.6265,2008-02-01,454111,15301313,60073914,7775520
"576","42251302490000",1986665.559,257428.6265,2008-03-01,512821,15814134,60073914,9152519
"577","42251302490000",1986665.559,257428.6265,2008-04-01,418190,16232324,60073914,8881211
"578","42251302490000",1986665.559,257428.6265,2008-05-01,525480,16757804,60073914,9790992
"579","42251302490000",1986665.559,257428.6265,2008-06-01,581410,17339214,60073914,9489076
"580","42251302490000",1986665.559,257428.6265,2008-07-01,539007,17878221,60073914,9342850
"581","42251302490000",1986665.559,257428.6265,2008-08-01,652779,18531000,60073914,9977335
"582","42251302490000",1986665.559,257428.6265,2008-09-01,709006,19240006,60073914,9513587
"583","42251302490000",1986665.559,257428.6265,2008-10-01,503138,19743144,60073914,9729575
"584","42251302490000",1986665.559,257428.6265,2008-11-01,459461,20202605,60073914,10178583
"585","42251302490000",1986665.559,257428.6265,2008-12-01,251550,20454155,60073914,9857864
"586","42251302490000",1986665.559,257428.6265,2009-01-01,232333,20686488,60073914,9714975
"587","42251302490000",1986665.559,257428.6265,2009-02-01,332491,21018979,60073914,9563848
"588","42251302490000",1986665.559,257428.6265,2009-03-01,383850,21402829,60073914,10011008
"589","42251302490000",1986665.559,257428.6265,2009-04-01,356374,21759203,60073914,8817835
"590","42251302490000",1986665.559,257428.6265,2009-05-01,436505,22195708,60073914,9222275
"591","42251302490000",1986665.559,257428.6265,2009-06-01,375349,22571057,60073914,8823798
"592","42251302490000",1986665.559,257428.6265,2009-07-01,410753,22981810,60073914,9681047
"593","42251302490000",1986665.559,257428.6265,2009-08-01,446599,23428409,60073914,10148823
"594","42251302490000",1986665.559,257428.6265,2009-09-01,456968,23885377,60073914,9880092
"595","42251302490000",1986665.559,257428.6265,2009-10-01,529886,24415263,60073914,10866851
"596","42251302490000",1986665.559,257428.6265,2009-11-01,453354,24868617,60073914,10107974
"597","42251302490000",1986665.559,257428.6265,2009-12-01,595813,25464430,60073914,10176315
"598","42251302490000",1986665.559,257428.6265,2010-01-01,616120,26080550,60073914,10900701
"599","42251302490000",1986665.559,257428.6265,2010-02-01,520188,26600738,60073914,10320596
"600","42251302490000",1986665.559,257428.6265,2010-03-01,497130,27097868,60073914,12054256
"601","42251302490000",1986665.559,257428.6265,2010-04-01,514374,27612242,60073914,11657482
"602","42251302490000",1986665.559,257428.6265,2010-05-01,502673,28114915,60073914,12361540
"603","42251302490000",1986665.559,257428.6265,2010-06-01,591587,28706502,60073914,11806317
"604","42251302490000",1986665.559,257428.6265,2010-07-01,657063,29363565,60073914,13014429
"605","42251302490000",1986665.559,257428.6265,2010-08-01,547407,29910972,60073914,12894731
"606","42251302490000",1986665.559,257428.6265,2010-09-01,589244,30500216,60073914,13014299
"607","42251302490000",1986665.559,257428.6265,2010-10-01,386644,30886860,60073914,11689154
"608","42251302490000",1986665.559,257428.6265,2010-11-01,595577,31482437,60073914,11954124
"609","42251302490000",1986665.559,257428.6265,2010-12-01,535073,32017510,60073914,12386935
"610","42251302490000",1986665.559,257428.6265,2011-01-01,549958,32567468,60073914,12491622
"611","42251302490000",1986665.559,257428.6265,2011-02-01,473725,33041193,60073914,10744516
"612","42251302490000",1986665.559,257428.6265,2011-03-01,496095,33537288,60073914,13585658
"613","42251302490000",1986665.559,257428.6265,2011-04-01,471802,34009090,60073914,13823700
"614","42251302490000",1986665.559,257428.6265,2011-05-01,450178,34459268,60073914,14893483
"615","42251302490000",1986665.559,257428.6265,2011-06-01,459746,34919014,60073914,13536023
"616","42251302490000",1986665.559,257428.6265,2011-07-01,468539,35387553,60073914,14060435
"617","42251302490000",1986665.559,257428.6265,2011-08-01,449239,35836792,60073914,13865713
"618","42251302490000",1986665.559,257428.6265,2011-09-01,416394,36253186,60073914,13575950
"619","42251302490000",1986665.559,257428.6265,2011-10-01,459641,36712827,60073914,14224672
"620","42251302490000",1986665.559,257428.6265,2011-11-01,425103,37137930,60073914,14289379
"621","42251302490000",1986665.559,257428.6265,2011-12-01,413295,37551225,60073914,14301497
"622","42251302490000",1986665.559,257428.6265,2012-01-01,421929,37973154,60073914,14393197
"623","42251302490000",1986665.559,257428.6265,2012-02-01,380871,38354025,60073914,13261820
"624","42251302490000",1986665.559,257428.6265,2012-03-01,426232,38780257,60073914,14719295
"625","42251302490000",1986665.559,257428.6265,2012-04-01,453312,39233569,60073914,13422939
"626","42251302490000",1986665.559,257428.6265,2012-05-01,533231,39766800,60073914,13619470
"627","42251302490000",1986665.559,257428.6265,2012-06-01,489533,40256333,60073914,12965656
"628","42251302490000",1986665.559,257428.6265,2012-07-01,485468,40741801,60073914,13735215
"629","42251302490000",1986665.559,257428.6265,2012-08-01,422812,41164613,60073914,13116786
"630","42251302490000",1986665.559,257428.6265,2012-09-01,498779,41663392,60073914,12508392
"631","42251302490000",1986665.559,257428.6265,2012-10-01,406873,42070265,60073914,12829987
"632","42251302490000",1986665.559,257428.6265,2012-11-01,375822,42446087,60073914,11811242
"633","42251302490000",1986665.559,257428.6265,2012-12-01,387654,42833741,60073914,12077125
"634","42251302490000",1986665.559,257428.6265,2013-01-01,387691,43221432,60073914,12754328
"635","42251302490000",1986665.559,257428.6265,2013-02-01,343952,43565384,60073914,11309584
"636","42251302490000",1986665.559,257428.6265,2013-03-01,397851,43963235,60073914,12445227
"637","42251302490000",1986665.559,257428.6265,2013-04-01,356433,44319668,60073914,11899338
"638","42251302490000",1986665.559,257428.6265,2013-05-01,250289,44569957,60073914,11963242
"639","42251302490000",1986665.559,257428.6265,2013-07-01,69782,44639739,60073914,12334827
"640","42251302490000",1986665.559,257428.6265,2013-08-01,359822,44999561,60073914,12036527
"641","42251302490000",1986665.559,257428.6265,2013-09-01,349804,45349365,60073914,11831621
"642","42251302490000",1986665.559,257428.6265,2013-10-01,348287,45697652,60073914,11912081
"643","42251302490000",1986665.559,257428.6265,2013-11-01,353689,46051341,60073914,11402351
"644","42251302490000",1986665.559,257428.6265,2013-12-01,362467,46413808,60073914,10800800
"645","42251302490000",1986665.559,257428.6265,2014-01-01,369880,46783688,60073914,11386084
"646","42251302490000",1986665.559,257428.6265,2014-02-01,325601,47109289,60073914,9936683
"647","42251302490000",1986665.559,257428.6265,2014-03-01,379304,47488593,60073914,12046987
"648","42251302490000",1986665.559,257428.6265,2014-04-01,356679,47845272,60073914,11738869
"649","42251302490000",1986665.559,257428.6265,2014-05-01,354040,48199312,60073914,12165041
"650","42251302490000",1986665.559,257428.6265,2014-06-01,351828,48551140,60073914,11720072
"651","42251302490000",1986665.559,257428.6265,2014-07-01,345843,48896983,60073914,11632955
"652","42251302490000",1986665.559,257428.6265,2014-08-01,329006,49225989,60073914,11280396
"653","42251302490000",1986665.559,257428.6265,2014-09-01,322654,49548643,60073914,10707843
"654","42251302490000",1986665.559,257428.6265,2014-10-01,33574,49582217,60073914,11154961
"655","42251302490000",1986665.559,257428.6265,2014-11-01,315575,49897792,60073914,11006198
"656","42251302490000",1986665.559,257428.6265,2014-12-01,321426,50219218,60073914,11175048
"657","42251302490000",1986665.559,257428.6265,2015-01-01,317114,50536332,60073914,11188192
"658","42251302490000",1986665.559,257428.6265,2015-02-01,285069,50821401,60073914,9285348
"659","42251302490000",1986665.559,257428.6265,2015-03-01,311791,51133192,60073914,11132951
"660","42251302490000",1986665.559,257428.6265,2015-04-01,298161,51431353,60073914,10228970
"661","42251302490000",1986665.559,257428.6265,2015-05-01,445109,51876462,60073914,10731832
"662","42251302490000",1986665.559,257428.6265,2015-06-01,540949,52417411,60073914,10019178
"663","42251302490000",1986665.559,257428.6265,2015-07-01,355983,52773394,60073914,9556838
"664","42251302490000",1986665.559,257428.6265,2015-08-01,314563,53087957,60073914,9046352
"665","42251302490000",1986665.559,257428.6265,2015-09-01,319505,53407462,60073914,8436833
"666","42251302490000",1986665.559,257428.6265,2015-10-01,309047,53716509,60073914,8702949
"667","42251302490000",1986665.559,257428.6265,2015-11-01,346463,54062972,60073914,8702391
"668","42251302490000",1986665.559,257428.6265,2015-12-01,357551,54420523,60073914,8797617
"669","42251302490000",1986665.559,257428.6265,2016-01-01,347560,54768083,60073914,8785697
"670","42251302490000",1986665.559,257428.6265,2016-02-01,220495,54988578,60073914,8098391
"671","42251302490000",1986665.559,257428.6265,2016-03-01,29533,55018111,60073914,8313445
"672","42251302490000",1986665.559,257428.6265,2016-04-01,275679,55293790,60073914,8067410
"673","42251302490000",1986665.559,257428.6265,2016-05-01,289189,55582979,60073914,8687363
"674","42251302490000",1986665.559,257428.6265,2016-06-01,303293,55886272,60073914,8474598
"675","42251302490000",1986665.559,257428.6265,2016-07-01,308231,56194503,60073914,8474294
"676","42251302490000",1986665.559,257428.6265,2016-08-01,307653,56502156,60073914,8424724
"677","42251302490000",1986665.559,257428.6265,2016-09-01,305773,56807929,60073914,7958587
"678","42251302490000",1986665.559,257428.6265,2016-10-01,88523,56896452,60073914,7328643
"679","42251302490000",1986665.559,257428.6265,2016-11-01,278686,57175138,60073914,7108192
"680","42251302490000",1986665.559,257428.6265,2016-12-01,283302,57458440,60073914,7206177
"681","42251302490000",1986665.559,257428.6265,2017-01-01,283872,57742312,60073914,8191419
"682","42251302490000",1986665.559,257428.6265,2017-02-01,223128,57965440,60073914,7284679
"683","42251302490000",1986665.559,257428.6265,2017-03-01,283411,58248851,60073914,7793859
"684","42251302490000",1986665.559,257428.6265,2017-04-01,314553,58563404,60073914,7558837
"685","42251302490000",1986665.559,257428.6265,2017-05-01,298199,58861603,60073914,7868617
"686","42251302490000",1986665.559,257428.6265,2017-06-01,298942,59160545,60073914,7593200
"687","42251302490000",1986665.559,257428.6265,2017-07-01,306481,59467026,60073914,8034023
"688","42251302490000",1986665.559,257428.6265,2017-08-01,306227,59773253,60073914,8259439
"689","42251302490000",1986665.559,257428.6265,2017-09-01,300661,60073914,60073914,7833970
"690","42251303850000",1967786.662,310697.0117,2006-08-01,81425,81425,58137783,2512715
"691","42251303850000",1967786.662,310697.0117,2006-09-01,254628,336053,58137783,2773616
"692","42251303850000",1967786.662,310697.0117,2006-10-01,412990,749043,58137783,3124548
"693","42251303850000",1967786.662,310697.0117,2006-11-01,447852,1196895,58137783,3240926
"694","42251303850000",1967786.662,310697.0117,2006-12-01,411334,1608229,58137783,4484941
"695","42251303850000",1967786.662,310697.0117,2007-01-01,451155,2059384,58137783,4380773
"696","42251303850000",1967786.662,310697.0117,2007-02-01,441093,2500477,58137783,4175393
"697","42251303850000",1967786.662,310697.0117,2007-03-01,417970,2918447,58137783,4620840
"698","42251303850000",1967786.662,310697.0117,2007-04-01,375629,3294076,58137783,4876542
"699","42251303850000",1967786.662,310697.0117,2007-05-01,554246,3848322,58137783,5347071
"700","42251303850000",1967786.662,310697.0117,2007-06-01,546709,4395031,58137783,5055569
"701","42251303850000",1967786.662,310697.0117,2007-07-01,557746,4952777,58137783,5639953
"702","42251303850000",1967786.662,310697.0117,2007-08-01,510019,5462796,58137783,5967755
"703","42251303850000",1967786.662,310697.0117,2007-09-01,525002,5987798,58137783,5629384
"704","42251303850000",1967786.662,310697.0117,2007-10-01,594655,6582453,58137783,6483309
"705","42251303850000",1967786.662,310697.0117,2007-11-01,655857,7238310,58137783,6157035
"706","42251303850000",1967786.662,310697.0117,2007-12-01,693853,7932163,58137783,5777613
"707","42251303850000",1967786.662,310697.0117,2008-01-01,637624,8569787,58137783,6452815
"708","42251303850000",1967786.662,310697.0117,2008-02-01,479597,9049384,58137783,7775520
"709","42251303850000",1967786.662,310697.0117,2008-03-01,466470,9515854,58137783,9152519
"710","42251303850000",1967786.662,310697.0117,2008-04-01,481776,9997630,58137783,8881211
"711","42251303850000",1967786.662,310697.0117,2008-05-01,583541,10581171,58137783,9790992
"712","42251303850000",1967786.662,310697.0117,2008-06-01,622682,11203853,58137783,9489076
"713","42251303850000",1967786.662,310697.0117,2008-07-01,579774,11783627,58137783,9342850
"714","42251303850000",1967786.662,310697.0117,2008-08-01,622707,12406334,58137783,9977335
"715","42251303850000",1967786.662,310697.0117,2008-09-01,483797,12890131,58137783,9513587
"716","42251303850000",1967786.662,310697.0117,2008-10-01,270066,13160197,58137783,9729575
"717","42251303850000",1967786.662,310697.0117,2008-11-01,316553,13476750,58137783,10178583
"718","42251303850000",1967786.662,310697.0117,2008-12-01,528260,14005010,58137783,9857864
"719","42251303850000",1967786.662,310697.0117,2009-01-01,465084,14470094,58137783,9714975
"720","42251303850000",1967786.662,310697.0117,2009-02-01,494133,14964227,58137783,9563848
"721","42251303850000",1967786.662,310697.0117,2009-03-01,479672,15443899,58137783,10011008
"722","42251303850000",1967786.662,310697.0117,2009-04-01,463927,15907826,58137783,8817835
"723","42251303850000",1967786.662,310697.0117,2009-05-01,490442,16398268,58137783,9222275
"724","42251303850000",1967786.662,310697.0117,2009-06-01,363082,16761350,58137783,8823798
"725","42251303850000",1967786.662,310697.0117,2009-07-01,519542,17280892,58137783,9681047
"726","42251303850000",1967786.662,310697.0117,2009-08-01,598618,17879510,58137783,10148823
"727","42251303850000",1967786.662,310697.0117,2009-09-01,567289,18446799,58137783,9880092
"728","42251303850000",1967786.662,310697.0117,2009-10-01,599958,19046757,58137783,10866851
"729","42251303850000",1967786.662,310697.0117,2009-11-01,584099,19630856,58137783,10107974
"730","42251303850000",1967786.662,310697.0117,2009-12-01,496922,20127778,58137783,10176315
"731","42251303850000",1967786.662,310697.0117,2010-01-01,542636,20670414,58137783,10900701
"732","42251303850000",1967786.662,310697.0117,2010-02-01,499668,21170082,58137783,10320596
"733","42251303850000",1967786.662,310697.0117,2010-03-01,530438,21700520,58137783,12054256
"734","42251303850000",1967786.662,310697.0117,2010-04-01,494209,22194729,58137783,11657482
"735","42251303850000",1967786.662,310697.0117,2010-05-01,475624,22670353,58137783,12361540
"736","42251303850000",1967786.662,310697.0117,2010-06-01,442547,23112900,58137783,11806317
"737","42251303850000",1967786.662,310697.0117,2010-07-01,475978,23588878,58137783,13014429
"738","42251303850000",1967786.662,310697.0117,2010-08-01,535754,24124632,58137783,12894731
"739","42251303850000",1967786.662,310697.0117,2010-09-01,507722,24632354,58137783,13014299
"740","42251303850000",1967786.662,310697.0117,2010-10-01,488329,25120683,58137783,11689154
"741","42251303850000",1967786.662,310697.0117,2010-11-01,422534,25543217,58137783,11954124
"742","42251303850000",1967786.662,310697.0117,2010-12-01,404555,25947772,58137783,12386935
"743","42251303850000",1967786.662,310697.0117,2011-01-01,522902,26470674,58137783,12491622
"744","42251303850000",1967786.662,310697.0117,2011-02-01,477557,26948231,58137783,10744516
"745","42251303850000",1967786.662,310697.0117,2011-03-01,587037,27535268,58137783,13585658
"746","42251303850000",1967786.662,310697.0117,2011-04-01,546779,28082047,58137783,13823700
"747","42251303850000",1967786.662,310697.0117,2011-05-01,589969,28672016,58137783,14893483
"748","42251303850000",1967786.662,310697.0117,2011-06-01,566067,29238083,58137783,13536023
"749","42251303850000",1967786.662,310697.0117,2011-07-01,561563,29799646,58137783,14060435
"750","42251303850000",1967786.662,310697.0117,2011-08-01,508846,30308492,58137783,13865713
"751","42251303850000",1967786.662,310697.0117,2011-09-01,548739,30857231,58137783,13575950
"752","42251303850000",1967786.662,310697.0117,2011-10-01,519708,31376939,58137783,14224672
"753","42251303850000",1967786.662,310697.0117,2011-11-01,448132,31825071,58137783,14289379
"754","42251303850000",1967786.662,310697.0117,2011-12-01,452905,32277976,58137783,14301497
"755","42251303850000",1967786.662,310697.0117,2012-01-01,526072,32804048,58137783,14393197
"756","42251303850000",1967786.662,310697.0117,2012-02-01,425366,33229414,58137783,13261820
"757","42251303850000",1967786.662,310697.0117,2012-03-01,431561,33660975,58137783,14719295
"758","42251303850000",1967786.662,310697.0117,2012-04-01,342084,34003059,58137783,13422939
"759","42251303850000",1967786.662,310697.0117,2012-05-01,333184,34336243,58137783,13619470
"760","42251303850000",1967786.662,310697.0117,2012-06-01,263759,34600002,58137783,12965656
"761","42251303850000",1967786.662,310697.0117,2012-07-01,285323,34885325,58137783,13735215
"762","42251303850000",1967786.662,310697.0117,2012-08-01,232059,35117384,58137783,13116786
"763","42251303850000",1967786.662,310697.0117,2012-09-01,276467,35393851,58137783,12508392
"764","42251303850000",1967786.662,310697.0117,2012-10-01,399257,35793108,58137783,12829987
"765","42251303850000",1967786.662,310697.0117,2012-11-01,368261,36161369,58137783,11811242
"766","42251303850000",1967786.662,310697.0117,2012-12-01,407205,36568574,58137783,12077125
"767","42251303850000",1967786.662,310697.0117,2013-01-01,466040,37034614,58137783,12754328
"768","42251303850000",1967786.662,310697.0117,2013-02-01,414253,37448867,58137783,11309584
"769","42251303850000",1967786.662,310697.0117,2013-03-01,471128,37919995,58137783,12445227
"770","42251303850000",1967786.662,310697.0117,2013-04-01,529197,38449192,58137783,11899338
"771","42251303850000",1967786.662,310697.0117,2013-05-01,349775,38798967,58137783,11963242
"772","42251303850000",1967786.662,310697.0117,2013-06-01,331490,39130457,58137783,11514151
"773","42251303850000",1967786.662,310697.0117,2013-07-01,388926,39519383,58137783,12334827
"774","42251303850000",1967786.662,310697.0117,2013-08-01,350625,39870008,58137783,12036527
"775","42251303850000",1967786.662,310697.0117,2013-09-01,323902,40193910,58137783,11831621
"776","42251303850000",1967786.662,310697.0117,2013-10-01,294583,40488493,58137783,11912081
"777","42251303850000",1967786.662,310697.0117,2013-11-01,201372,40689865,58137783,11402351
"778","42251303850000",1967786.662,310697.0117,2013-12-01,190686,40880551,58137783,10800800
"779","42251303850000",1967786.662,310697.0117,2014-01-01,215374,41095925,58137783,11386084
"780","42251303850000",1967786.662,310697.0117,2014-02-01,224575,41320500,58137783,9936683
"781","42251303850000",1967786.662,310697.0117,2014-03-01,414473,41734973,58137783,12046987
"782","42251303850000",1967786.662,310697.0117,2014-04-01,406308,42141281,58137783,11738869
"783","42251303850000",1967786.662,310697.0117,2014-05-01,392566,42533847,58137783,12165041
"784","42251303850000",1967786.662,310697.0117,2014-06-01,512267,43046114,58137783,11720072
"785","42251303850000",1967786.662,310697.0117,2014-07-01,548709,43594823,58137783,11632955
"786","42251303850000",1967786.662,310697.0117,2014-08-01,587795,44182618,58137783,11280396
"787","42251303850000",1967786.662,310697.0117,2014-09-01,555853,44738471,58137783,10707843
"788","42251303850000",1967786.662,310697.0117,2014-10-01,554628,45293099,58137783,11154961
"789","42251303850000",1967786.662,310697.0117,2014-11-01,530202,45823301,58137783,11006198
"790","42251303850000",1967786.662,310697.0117,2014-12-01,541129,46364430,58137783,11175048
"791","42251303850000",1967786.662,310697.0117,2015-01-01,502378,46866808,58137783,11188192
"792","42251303850000",1967786.662,310697.0117,2015-02-01,422762,47289570,58137783,9285348
"793","42251303850000",1967786.662,310697.0117,2015-03-01,500761,47790331,58137783,11132951
"794","42251303850000",1967786.662,310697.0117,2015-04-01,444456,48234787,58137783,10228970
"795","42251303850000",1967786.662,310697.0117,2015-05-01,449962,48684749,58137783,10731832
"796","42251303850000",1967786.662,310697.0117,2015-06-01,355982,49040731,58137783,10019178
"797","42251303850000",1967786.662,310697.0117,2015-07-01,277506,49318237,58137783,9556838
"798","42251303850000",1967786.662,310697.0117,2015-08-01,289509,49607746,58137783,9046352
"799","42251303850000",1967786.662,310697.0117,2015-09-01,287898,49895644,58137783,8436833
"800","42251303850000",1967786.662,310697.0117,2015-10-01,312205,50207849,58137783,8702949
"801","42251303850000",1967786.662,310697.0117,2015-11-01,232848,50440697,58137783,8702391
"802","42251303850000",1967786.662,310697.0117,2015-12-01,268300,50708997,58137783,8797617
"803","42251303850000",1967786.662,310697.0117,2016-01-01,252625,50961622,58137783,8785697
"804","42251303850000",1967786.662,310697.0117,2016-02-01,272479,51234101,58137783,8098391
"805","42251303850000",1967786.662,310697.0117,2016-03-01,361067,51595168,58137783,8313445
"806","42251303850000",1967786.662,310697.0117,2016-04-01,372877,51968045,58137783,8067410
"807","42251303850000",1967786.662,310697.0117,2016-05-01,350918,52318963,58137783,8687363
"808","42251303850000",1967786.662,310697.0117,2016-06-01,320540,52639503,58137783,8474598
"809","42251303850000",1967786.662,310697.0117,2016-07-01,273340,52912843,58137783,8474294
"810","42251303850000",1967786.662,310697.0117,2016-08-01,276092,53188935,58137783,8424724
"811","42251303850000",1967786.662,310697.0117,2016-09-01,319064,53507999,58137783,7958587
"812","42251303850000",1967786.662,310697.0117,2016-10-01,342866,53850865,58137783,7328643
"813","42251303850000",1967786.662,310697.0117,2016-11-01,335295,54186160,58137783,7108192
"814","42251303850000",1967786.662,310697.0117,2016-12-01,321640,54507800,58137783,7206177
"815","42251303850000",1967786.662,310697.0117,2017-01-01,247385,54755185,58137783,8191419
"816","42251303850000",1967786.662,310697.0117,2017-02-01,320240,55075425,58137783,7284679
"817","42251303850000",1967786.662,310697.0117,2017-03-01,409734,55485159,58137783,7793859
"818","42251303850000",1967786.662,310697.0117,2017-04-01,416875,55902034,58137783,7558837
"819","42251303850000",1967786.662,310697.0117,2017-05-01,428364,56330398,58137783,7868617
"820","42251303850000",1967786.662,310697.0117,2017-06-01,434848,56765246,58137783,7593200
"821","42251303850000",1967786.662,310697.0117,2017-07-01,452768,57218014,58137783,8034023
"822","42251303850000",1967786.662,310697.0117,2017-08-01,459253,57677267,58137783,8259439
"823","42251303850000",1967786.662,310697.0117,2017-09-01,460516,58137783,58137783,7833970
"824","42251304280000",1976123.641,309743.9399,2006-01-01,53812,53812,45058356,1350182
"825","42251304280000",1976123.641,309743.9399,2006-02-01,146989,200801,45058356,1472478
"826","42251304280000",1976123.641,309743.9399,2006-03-01,68824,269625,45058356,1848901
"827","42251304280000",1976123.641,309743.9399,2006-04-01,144325,413950,45058356,1923527
"828","42251304280000",1976123.641,309743.9399,2006-05-01,368640,782590,45058356,2207406
"829","42251304280000",1976123.641,309743.9399,2006-06-01,308160,1090750,45058356,1973653
"830","42251304280000",1976123.641,309743.9399,2006-07-01,536632,1627382,45058356,2021893
"831","42251304280000",1976123.641,309743.9399,2006-08-01,273720,1901102,45058356,2512715
"832","42251304280000",1976123.641,309743.9399,2006-09-01,327358,2228460,45058356,2773616
"833","42251304280000",1976123.641,309743.9399,2006-10-01,264225,2492685,45058356,3124548
"834","42251304280000",1976123.641,309743.9399,2006-11-01,320315,2813000,45058356,3240926
"835","42251304280000",1976123.641,309743.9399,2006-12-01,341551,3154551,45058356,4484941
"836","42251304280000",1976123.641,309743.9399,2007-01-01,343227,3497778,45058356,4380773
"837","42251304280000",1976123.641,309743.9399,2007-02-01,276843,3774621,45058356,4175393
"838","42251304280000",1976123.641,309743.9399,2007-03-01,316548,4091169,45058356,4620840
"839","42251304280000",1976123.641,309743.9399,2007-04-01,389729,4480898,45058356,4876542
"840","42251304280000",1976123.641,309743.9399,2007-05-01,292361,4773259,45058356,5347071
"841","42251304280000",1976123.641,309743.9399,2007-06-01,333910,5107169,45058356,5055569
"842","42251304280000",1976123.641,309743.9399,2007-07-01,332651,5439820,45058356,5639953
"843","42251304280000",1976123.641,309743.9399,2007-08-01,376895,5816715,45058356,5967755
"844","42251304280000",1976123.641,309743.9399,2007-09-01,378628,6195343,45058356,5629384
"845","42251304280000",1976123.641,309743.9399,2007-10-01,330324,6525667,45058356,6483309
"846","42251304280000",1976123.641,309743.9399,2007-11-01,359196,6884863,45058356,6157035
"847","42251304280000",1976123.641,309743.9399,2007-12-01,345520,7230383,45058356,5777613
"848","42251304280000",1976123.641,309743.9399,2008-01-01,320728,7551111,45058356,6452815
"849","42251304280000",1976123.641,309743.9399,2008-02-01,311633,7862744,45058356,7775520
"850","42251304280000",1976123.641,309743.9399,2008-03-01,334912,8197656,45058356,9152519
"851","42251304280000",1976123.641,309743.9399,2008-04-01,362624,8560280,45058356,8881211
"852","42251304280000",1976123.641,309743.9399,2008-05-01,389943,8950223,45058356,9790992
"853","42251304280000",1976123.641,309743.9399,2008-06-01,392059,9342282,45058356,9489076
"854","42251304280000",1976123.641,309743.9399,2008-07-01,342690,9684972,45058356,9342850
"855","42251304280000",1976123.641,309743.9399,2008-08-01,342449,10027421,45058356,9977335
"856","42251304280000",1976123.641,309743.9399,2008-09-01,375823,10403244,45058356,9513587
"857","42251304280000",1976123.641,309743.9399,2008-10-01,349408,10752652,45058356,9729575
"858","42251304280000",1976123.641,309743.9399,2008-11-01,426186,11178838,45058356,10178583
"859","42251304280000",1976123.641,309743.9399,2008-12-01,447959,11626797,45058356,9857864
"860","42251304280000",1976123.641,309743.9399,2009-01-01,416261,12043058,45058356,9714975
"861","42251304280000",1976123.641,309743.9399,2009-02-01,334833,12377891,45058356,9563848
"862","42251304280000",1976123.641,309743.9399,2009-03-01,402205,12780096,45058356,10011008
"863","42251304280000",1976123.641,309743.9399,2009-04-01,209979,12990075,45058356,8817835
"864","42251304280000",1976123.641,309743.9399,2009-05-01,255679,13245754,45058356,9222275
"865","42251304280000",1976123.641,309743.9399,2009-06-01,215075,13460829,45058356,8823798
"866","42251304280000",1976123.641,309743.9399,2009-07-01,253190,13714019,45058356,9681047
"867","42251304280000",1976123.641,309743.9399,2009-08-01,226961,13940980,45058356,10148823
"868","42251304280000",1976123.641,309743.9399,2009-09-01,137021,14078001,45058356,9880092
"869","42251304280000",1976123.641,309743.9399,2010-02-01,72534,14150535,45058356,10320596
"870","42251304280000",1976123.641,309743.9399,2010-03-01,164422,14314957,45058356,12054256
"871","42251304280000",1976123.641,309743.9399,2010-04-01,144267,14459224,45058356,11657482
"872","42251304280000",1976123.641,309743.9399,2010-05-01,307798,14767022,45058356,12361540
"873","42251304280000",1976123.641,309743.9399,2010-06-01,464203,15231225,45058356,11806317
"874","42251304280000",1976123.641,309743.9399,2010-07-01,369274,15600499,45058356,13014429
"875","42251304280000",1976123.641,309743.9399,2010-08-01,444320,16044819,45058356,12894731
"876","42251304280000",1976123.641,309743.9399,2010-09-01,424307,16469126,45058356,13014299
"877","42251304280000",1976123.641,309743.9399,2010-10-01,238689,16707815,45058356,11689154
"878","42251304280000",1976123.641,309743.9399,2010-11-01,368002,17075817,45058356,11954124
"879","42251304280000",1976123.641,309743.9399,2010-12-01,383326,17459143,45058356,12386935
"880","42251304280000",1976123.641,309743.9399,2011-01-01,376666,17835809,45058356,12491622
"881","42251304280000",1976123.641,309743.9399,2011-02-01,310878,18146687,45058356,10744516
"882","42251304280000",1976123.641,309743.9399,2011-03-01,395584,18542271,45058356,13585658
"883","42251304280000",1976123.641,309743.9399,2011-04-01,344093,18886364,45058356,13823700
"884","42251304280000",1976123.641,309743.9399,2011-05-01,353901,19240265,45058356,14893483
"885","42251304280000",1976123.641,309743.9399,2011-06-01,341263,19581528,45058356,13536023
"886","42251304280000",1976123.641,309743.9399,2011-07-01,345113,19926641,45058356,14060435
"887","42251304280000",1976123.641,309743.9399,2011-08-01,318339,20244980,45058356,13865713
"888","42251304280000",1976123.641,309743.9399,2011-09-01,337466,20582446,45058356,13575950
"889","42251304280000",1976123.641,309743.9399,2011-10-01,356920,20939366,45058356,14224672
"890","42251304280000",1976123.641,309743.9399,2011-11-01,330004,21269370,45058356,14289379
"891","42251304280000",1976123.641,309743.9399,2011-12-01,335833,21605203,45058356,14301497
"892","42251304280000",1976123.641,309743.9399,2012-01-01,323513,21928716,45058356,14393197
"893","42251304280000",1976123.641,309743.9399,2012-02-01,294521,22223237,45058356,13261820
"894","42251304280000",1976123.641,309743.9399,2012-03-01,305614,22528851,45058356,14719295
"895","42251304280000",1976123.641,309743.9399,2012-04-01,365424,22894275,45058356,13422939
"896","42251304280000",1976123.641,309743.9399,2012-05-01,398789,23293064,45058356,13619470
"897","42251304280000",1976123.641,309743.9399,2012-06-01,337033,23630097,45058356,12965656
"898","42251304280000",1976123.641,309743.9399,2012-07-01,335813,23965910,45058356,13735215
"899","42251304280000",1976123.641,309743.9399,2012-08-01,382348,24348258,45058356,13116786
"900","42251304280000",1976123.641,309743.9399,2012-09-01,386547,24734805,45058356,12508392
"901","42251304280000",1976123.641,309743.9399,2012-10-01,381880,25116685,45058356,12829987
"902","42251304280000",1976123.641,309743.9399,2012-11-01,367851,25484536,45058356,11811242
"903","42251304280000",1976123.641,309743.9399,2012-12-01,375543,25860079,45058356,12077125
"904","42251304280000",1976123.641,309743.9399,2013-01-01,366344,26226423,45058356,12754328
"905","42251304280000",1976123.641,309743.9399,2013-02-01,323489,26549912,45058356,11309584
"906","42251304280000",1976123.641,309743.9399,2013-03-01,343802,26893714,45058356,12445227
"907","42251304280000",1976123.641,309743.9399,2013-04-01,315547,27209261,45058356,11899338
"908","42251304280000",1976123.641,309743.9399,2013-05-01,371768,27581029,45058356,11963242
"909","42251304280000",1976123.641,309743.9399,2013-06-01,531543,28112572,45058356,11514151
"910","42251304280000",1976123.641,309743.9399,2013-07-01,499350,28611922,45058356,12334827
"911","42251304280000",1976123.641,309743.9399,2013-08-01,348710,28960632,45058356,12036527
"912","42251304280000",1976123.641,309743.9399,2013-09-01,324988,29285620,45058356,11831621
"913","42251304280000",1976123.641,309743.9399,2013-10-01,342950,29628570,45058356,11912081
"914","42251304280000",1976123.641,309743.9399,2013-11-01,349844,29978414,45058356,11402351
"915","42251304280000",1976123.641,309743.9399,2013-12-01,353809,30332223,45058356,10800800
"916","42251304280000",1976123.641,309743.9399,2014-01-01,372074,30704297,45058356,11386084
"917","42251304280000",1976123.641,309743.9399,2014-02-01,321690,31025987,45058356,9936683
"918","42251304280000",1976123.641,309743.9399,2014-03-01,354257,31380244,45058356,12046987
"919","42251304280000",1976123.641,309743.9399,2014-04-01,356604,31736848,45058356,11738869
"920","42251304280000",1976123.641,309743.9399,2014-05-01,357216,32094064,45058356,12165041
"921","42251304280000",1976123.641,309743.9399,2014-06-01,343966,32438030,45058356,11720072
"922","42251304280000",1976123.641,309743.9399,2014-07-01,345367,32783397,45058356,11632955
"923","42251304280000",1976123.641,309743.9399,2014-08-01,343185,33126582,45058356,11280396
"924","42251304280000",1976123.641,309743.9399,2014-09-01,323656,33450238,45058356,10707843
"925","42251304280000",1976123.641,309743.9399,2014-10-01,337183,33787421,45058356,11154961
"926","42251304280000",1976123.641,309743.9399,2014-11-01,322058,34109479,45058356,11006198
"927","42251304280000",1976123.641,309743.9399,2014-12-01,338488,34447967,45058356,11175048
"928","42251304280000",1976123.641,309743.9399,2015-01-01,340657,34788624,45058356,11188192
"929","42251304280000",1976123.641,309743.9399,2015-02-01,302728,35091352,45058356,9285348
"930","42251304280000",1976123.641,309743.9399,2015-03-01,348313,35439665,45058356,11132951
"931","42251304280000",1976123.641,309743.9399,2015-04-01,325929,35765594,45058356,10228970
"932","42251304280000",1976123.641,309743.9399,2015-05-01,339377,36104971,45058356,10731832
"933","42251304280000",1976123.641,309743.9399,2015-06-01,378717,36483688,45058356,10019178
"934","42251304280000",1976123.641,309743.9399,2015-07-01,389943,36873631,45058356,9556838
"935","42251304280000",1976123.641,309743.9399,2015-08-01,374683,37248314,45058356,9046352
"936","42251304280000",1976123.641,309743.9399,2015-09-01,364703,37613017,45058356,8436833
"937","42251304280000",1976123.641,309743.9399,2015-10-01,339330,37952347,45058356,8702949
"938","42251304280000",1976123.641,309743.9399,2015-11-01,327121,38279468,45058356,8702391
"939","42251304280000",1976123.641,309743.9399,2015-12-01,329186,38608654,45058356,8797617
"940","42251304280000",1976123.641,309743.9399,2016-01-01,413651,39022305,45058356,8785697
"941","42251304280000",1976123.641,309743.9399,2016-02-01,444061,39466366,45058356,8098391
"942","42251304280000",1976123.641,309743.9399,2016-03-01,355706,39822072,45058356,8313445
"943","42251304280000",1976123.641,309743.9399,2016-04-01,341108,40163180,45058356,8067410
"944","42251304280000",1976123.641,309743.9399,2016-05-01,331781,40494961,45058356,8687363
"945","42251304280000",1976123.641,309743.9399,2016-06-01,326314,40821275,45058356,8474598
"946","42251304280000",1976123.641,309743.9399,2016-07-01,319524,41140799,45058356,8474294
"947","42251304280000",1976123.641,309743.9399,2016-08-01,285512,41426311,45058356,8424724
"948","42251304280000",1976123.641,309743.9399,2016-09-01,284874,41711185,45058356,7958587
"949","42251304280000",1976123.641,309743.9399,2016-10-01,374506,42085691,45058356,7328643
"950","42251304280000",1976123.641,309743.9399,2016-11-01,231421,42317112,45058356,7108192
"951","42251304280000",1976123.641,309743.9399,2016-12-01,283624,42600736,45058356,7206177
"952","42251304280000",1976123.641,309743.9399,2017-01-01,294081,42894817,45058356,8191419
"953","42251304280000",1976123.641,309743.9399,2017-02-01,230543,43125360,45058356,7284679
"954","42251304280000",1976123.641,309743.9399,2017-03-01,279022,43404382,45058356,7793859
"955","42251304280000",1976123.641,309743.9399,2017-04-01,279201,43683583,45058356,7558837
"956","42251304280000",1976123.641,309743.9399,2017-05-01,284675,43968258,45058356,7868617
"957","42251304280000",1976123.641,309743.9399,2017-06-01,265547,44233805,45058356,7593200
"958","42251304280000",1976123.641,309743.9399,2017-07-01,272459,44506264,45058356,8034023
"959","42251304280000",1976123.641,309743.9399,2017-08-01,275682,44781946,45058356,8259439
"960","42251304280000",1976123.641,309743.9399,2017-09-01,276410,45058356,45058356,7833970
"961","42251304810000",2057285.857,243856.1445,2007-04-01,93682,93682,25693553,4876542
"962","42251304810000",2057285.857,243856.1445,2007-05-01,369391,463073,25693553,5347071
"963","42251304810000",2057285.857,243856.1445,2007-06-01,234076,697149,25693553,5055569
"964","42251304810000",2057285.857,243856.1445,2007-07-01,357738,1054887,25693553,5639953
"965","42251304810000",2057285.857,243856.1445,2007-08-01,226568,1281455,25693553,5967755
"966","42251304810000",2057285.857,243856.1445,2007-09-01,349746,1631201,25693553,5629384
"967","42251304810000",2057285.857,243856.1445,2007-10-01,421421,2052622,25693553,6483309
"968","42251304810000",2057285.857,243856.1445,2007-11-01,311450,2364072,25693553,6157035
"969","42251304810000",2057285.857,243856.1445,2007-12-01,179166,2543238,25693553,5777613
"970","42251304810000",2057285.857,243856.1445,2008-01-01,276257,2819495,25693553,6452815
"971","42251304810000",2057285.857,243856.1445,2008-02-01,376576,3196071,25693553,7775520
"972","42251304810000",2057285.857,243856.1445,2008-03-01,432224,3628295,25693553,9152519
"973","42251304810000",2057285.857,243856.1445,2008-04-01,463215,4091510,25693553,8881211
"974","42251304810000",2057285.857,243856.1445,2008-05-01,534987,4626497,25693553,9790992
"975","42251304810000",2057285.857,243856.1445,2008-06-01,442855,5069352,25693553,9489076
"976","42251304810000",2057285.857,243856.1445,2008-07-01,521908,5591260,25693553,9342850
"977","42251304810000",2057285.857,243856.1445,2008-08-01,554502,6145762,25693553,9977335
"978","42251304810000",2057285.857,243856.1445,2008-09-01,420449,6566211,25693553,9513587
"979","42251304810000",2057285.857,243856.1445,2008-10-01,496791,7063002,25693553,9729575
"980","42251304810000",2057285.857,243856.1445,2008-11-01,530358,7593360,25693553,10178583
"981","42251304810000",2057285.857,243856.1445,2008-12-01,558920,8152280,25693553,9857864
"982","42251304810000",2057285.857,243856.1445,2009-01-01,496456,8648736,25693553,9714975
"983","42251304810000",2057285.857,243856.1445,2009-02-01,508642,9157378,25693553,9563848
"984","42251304810000",2057285.857,243856.1445,2009-03-01,369771,9527149,25693553,10011008
"985","42251304810000",2057285.857,243856.1445,2009-04-01,376040,9903189,25693553,8817835
"986","42251304810000",2057285.857,243856.1445,2009-05-01,353650,10256839,25693553,9222275
"987","42251304810000",2057285.857,243856.1445,2009-06-01,363909,10620748,25693553,8823798
"988","42251304810000",2057285.857,243856.1445,2009-07-01,387508,11008256,25693553,9681047
"989","42251304810000",2057285.857,243856.1445,2009-08-01,215923,11224179,25693553,10148823
"990","42251304810000",2057285.857,243856.1445,2009-09-01,241398,11465577,25693553,9880092
"991","42251304810000",2057285.857,243856.1445,2009-10-01,249170,11714747,25693553,10866851
"992","42251304810000",2057285.857,243856.1445,2009-11-01,242955,11957702,25693553,10107974
"993","42251304810000",2057285.857,243856.1445,2009-12-01,251581,12209283,25693553,10176315
"994","42251304810000",2057285.857,243856.1445,2010-01-01,321843,12531126,25693553,10900701
"995","42251304810000",2057285.857,243856.1445,2010-02-01,304153,12835279,25693553,10320596
"996","42251304810000",2057285.857,243856.1445,2010-03-01,315582,13150861,25693553,12054256
"997","42251304810000",2057285.857,243856.1445,2010-04-01,255863,13406724,25693553,11657482
"998","42251304810000",2057285.857,243856.1445,2010-05-01,337810,13744534,25693553,12361540
"999","42251304810000",2057285.857,243856.1445,2010-06-01,308073,14052607,25693553,11806317
"1000","42251304810000",2057285.857,243856.1445,2010-07-01,273500,14326107,25693553,13014429
"1001","42251304810000",2057285.857,243856.1445,2010-08-01,260853,14586960,25693553,12894731
"1002","42251304810000",2057285.857,243856.1445,2010-09-01,266298,14853258,25693553,13014299
"1003","42251304810000",2057285.857,243856.1445,2010-10-01,286962,15140220,25693553,11689154
"1004","42251304810000",2057285.857,243856.1445,2010-11-01,264456,15404676,25693553,11954124
"1005","42251304810000",2057285.857,243856.1445,2010-12-01,246142,15650818,25693553,12386935
"1006","42251304810000",2057285.857,243856.1445,2011-01-01,222102,15872920,25693553,12491622
"1007","42251304810000",2057285.857,243856.1445,2011-02-01,188861,16061781,25693553,10744516
"1008","42251304810000",2057285.857,243856.1445,2011-03-01,219231,16281012,25693553,13585658
"1009","42251304810000",2057285.857,243856.1445,2011-04-01,187693,16468705,25693553,13823700
"1010","42251304810000",2057285.857,243856.1445,2011-05-01,162849,16631554,25693553,14893483
"1011","42251304810000",2057285.857,243856.1445,2011-06-01,152233,16783787,25693553,13536023
"1012","42251304810000",2057285.857,243856.1445,2011-07-01,180885,16964672,25693553,14060435
"1013","42251304810000",2057285.857,243856.1445,2011-08-01,181787,17146459,25693553,13865713
"1014","42251304810000",2057285.857,243856.1445,2011-09-01,164797,17311256,25693553,13575950
"1015","42251304810000",2057285.857,243856.1445,2011-10-01,159589,17470845,25693553,14224672
"1016","42251304810000",2057285.857,243856.1445,2011-11-01,182693,17653538,25693553,14289379
"1017","42251304810000",2057285.857,243856.1445,2011-12-01,172267,17825805,25693553,14301497
"1018","42251304810000",2057285.857,243856.1445,2012-01-01,182820,18008625,25693553,14393197
"1019","42251304810000",2057285.857,243856.1445,2012-02-01,164309,18172934,25693553,13261820
"1020","42251304810000",2057285.857,243856.1445,2012-03-01,166437,18339371,25693553,14719295
"1021","42251304810000",2057285.857,243856.1445,2012-04-01,144344,18483715,25693553,13422939
"1022","42251304810000",2057285.857,243856.1445,2012-05-01,157156,18640871,25693553,13619470
"1023","42251304810000",2057285.857,243856.1445,2012-06-01,162121,18802992,25693553,12965656
"1024","42251304810000",2057285.857,243856.1445,2012-07-01,185912,18988904,25693553,13735215
"1025","42251304810000",2057285.857,243856.1445,2012-08-01,195520,19184424,25693553,13116786
"1026","42251304810000",2057285.857,243856.1445,2012-09-01,173058,19357482,25693553,12508392
"1027","42251304810000",2057285.857,243856.1445,2012-10-01,119856,19477338,25693553,12829987
"1028","42251304810000",2057285.857,243856.1445,2012-11-01,118824,19596162,25693553,11811242
"1029","42251304810000",2057285.857,243856.1445,2012-12-01,208337,19804499,25693553,12077125
"1030","42251304810000",2057285.857,243856.1445,2013-01-01,184132,19988631,25693553,12754328
"1031","42251304810000",2057285.857,243856.1445,2013-02-01,161648,20150279,25693553,11309584
"1032","42251304810000",2057285.857,243856.1445,2013-03-01,157724,20308003,25693553,12445227
"1033","42251304810000",2057285.857,243856.1445,2013-04-01,110706,20418709,25693553,11899338
"1034","42251304810000",2057285.857,243856.1445,2013-05-01,135122,20553831,25693553,11963242
"1035","42251304810000",2057285.857,243856.1445,2013-06-01,126073,20679904,25693553,11514151
"1036","42251304810000",2057285.857,243856.1445,2013-07-01,131689,20811593,25693553,12334827
"1037","42251304810000",2057285.857,243856.1445,2013-08-01,127761,20939354,25693553,12036527
"1038","42251304810000",2057285.857,243856.1445,2013-09-01,118708,21058062,25693553,11831621
"1039","42251304810000",2057285.857,243856.1445,2013-10-01,142290,21200352,25693553,11912081
"1040","42251304810000",2057285.857,243856.1445,2013-11-01,136509,21336861,25693553,11402351
"1041","42251304810000",2057285.857,243856.1445,2013-12-01,121284,21458145,25693553,10800800
"1042","42251304810000",2057285.857,243856.1445,2014-01-01,124339,21582484,25693553,11386084
"1043","42251304810000",2057285.857,243856.1445,2014-02-01,132818,21715302,25693553,9936683
"1044","42251304810000",2057285.857,243856.1445,2014-03-01,125043,21840345,25693553,12046987
"1045","42251304810000",2057285.857,243856.1445,2014-04-01,111912,21952257,25693553,11738869
"1046","42251304810000",2057285.857,243856.1445,2014-05-01,124167,22076424,25693553,12165041
"1047","42251304810000",2057285.857,243856.1445,2014-06-01,117943,22194367,25693553,11720072
"1048","42251304810000",2057285.857,243856.1445,2014-07-01,119351,22313718,25693553,11632955
"1049","42251304810000",2057285.857,243856.1445,2014-08-01,112171,22425889,25693553,11280396
"1050","42251304810000",2057285.857,243856.1445,2014-09-01,105180,22531069,25693553,10707843
"1051","42251304810000",2057285.857,243856.1445,2014-10-01,105961,22637030,25693553,11154961
"1052","42251304810000",2057285.857,243856.1445,2014-11-01,99047,22736077,25693553,11006198
"1053","42251304810000",2057285.857,243856.1445,2014-12-01,98696,22834773,25693553,11175048
"1054","42251304810000",2057285.857,243856.1445,2015-01-01,111202,22945975,25693553,11188192
"1055","42251304810000",2057285.857,243856.1445,2015-02-01,95460,23041435,25693553,9285348
"1056","42251304810000",2057285.857,243856.1445,2015-03-01,122561,23163996,25693553,11132951
"1057","42251304810000",2057285.857,243856.1445,2015-04-01,112132,23276128,25693553,10228970
"1058","42251304810000",2057285.857,243856.1445,2015-05-01,136896,23413024,25693553,10731832
"1059","42251304810000",2057285.857,243856.1445,2015-06-01,113665,23526689,25693553,10019178
"1060","42251304810000",2057285.857,243856.1445,2015-07-01,99516,23626205,25693553,9556838
"1061","42251304810000",2057285.857,243856.1445,2015-08-01,103050,23729255,25693553,9046352
"1062","42251304810000",2057285.857,243856.1445,2015-09-01,95595,23824850,25693553,8436833
"1063","42251304810000",2057285.857,243856.1445,2015-10-01,93281,23918131,25693553,8702949
"1064","42251304810000",2057285.857,243856.1445,2015-11-01,103838,24021969,25693553,8702391
"1065","42251304810000",2057285.857,243856.1445,2015-12-01,112048,24134017,25693553,8797617
"1066","42251304810000",2057285.857,243856.1445,2016-01-01,101115,24235132,25693553,8785697
"1067","42251304810000",2057285.857,243856.1445,2016-02-01,78288,24313420,25693553,8098391
"1068","42251304810000",2057285.857,243856.1445,2016-03-01,97911,24411331,25693553,8313445
"1069","42251304810000",2057285.857,243856.1445,2016-04-01,33688,24445019,25693553,8067410
"1070","42251304810000",2057285.857,243856.1445,2016-05-01,34919,24479938,25693553,8687363
"1071","42251304810000",2057285.857,243856.1445,2016-06-01,81462,24561400,25693553,8474598
"1072","42251304810000",2057285.857,243856.1445,2016-07-01,84063,24645463,25693553,8474294
"1073","42251304810000",2057285.857,243856.1445,2016-08-01,60593,24706056,25693553,8424724
"1074","42251304810000",2057285.857,243856.1445,2016-09-01,57566,24763622,25693553,7958587
"1075","42251304810000",2057285.857,243856.1445,2016-10-01,77180,24840802,25693553,7328643
"1076","42251304810000",2057285.857,243856.1445,2016-11-01,76328,24917130,25693553,7108192
"1077","42251304810000",2057285.857,243856.1445,2016-12-01,69491,24986621,25693553,7206177
"1078","42251304810000",2057285.857,243856.1445,2017-01-01,71060,25057681,25693553,8191419
"1079","42251304810000",2057285.857,243856.1445,2017-02-01,68097,25125778,25693553,7284679
"1080","42251304810000",2057285.857,243856.1445,2017-03-01,76694,25202472,25693553,7793859
"1081","42251304810000",2057285.857,243856.1445,2017-04-01,93618,25296090,25693553,7558837
"1082","42251304810000",2057285.857,243856.1445,2017-05-01,83868,25379958,25693553,7868617
"1083","42251304810000",2057285.857,243856.1445,2017-06-01,84058,25464016,25693553,7593200
"1084","42251304810000",2057285.857,243856.1445,2017-07-01,75262,25539278,25693553,8034023
"1085","42251304810000",2057285.857,243856.1445,2017-08-01,81733,25621011,25693553,8259439
"1086","42251304810000",2057285.857,243856.1445,2017-09-01,72542,25693553,25693553,7833970
"1087","42251304890000",1968135.462,311202.3333,2006-09-01,106363,106363,39588782,2773616
"1088","42251304890000",1968135.462,311202.3333,2006-10-01,276141,382504,39588782,3124548
"1089","42251304890000",1968135.462,311202.3333,2006-11-01,329926,712430,39588782,3240926
"1090","42251304890000",1968135.462,311202.3333,2006-12-01,768004,1480434,39588782,4484941
"1091","42251304890000",1968135.462,311202.3333,2007-01-01,765423,2245857,39588782,4380773
"1092","42251304890000",1968135.462,311202.3333,2007-02-01,702459,2948316,39588782,4175393
"1093","42251304890000",1968135.462,311202.3333,2007-03-01,726354,3674670,39588782,4620840
"1094","42251304890000",1968135.462,311202.3333,2007-04-01,766310,4440980,39588782,4876542
"1095","42251304890000",1968135.462,311202.3333,2007-05-01,839020,5280000,39588782,5347071
"1096","42251304890000",1968135.462,311202.3333,2007-06-01,730431,6010431,39588782,5055569
"1097","42251304890000",1968135.462,311202.3333,2007-07-01,745184,6755615,39588782,5639953
"1098","42251304890000",1968135.462,311202.3333,2007-08-01,755063,7510678,39588782,5967755
"1099","42251304890000",1968135.462,311202.3333,2007-09-01,599105,8109783,39588782,5629384
"1100","42251304890000",1968135.462,311202.3333,2007-10-01,781882,8891665,39588782,6483309
"1101","42251304890000",1968135.462,311202.3333,2007-11-01,751533,9643198,39588782,6157035
"1102","42251304890000",1968135.462,311202.3333,2007-12-01,722342,10365540,39588782,5777613
"1103","42251304890000",1968135.462,311202.3333,2008-01-01,597090,10962630,39588782,6452815
"1104","42251304890000",1968135.462,311202.3333,2008-02-01,597391,11560021,39588782,7775520
"1105","42251304890000",1968135.462,311202.3333,2008-03-01,732064,12292085,39588782,9152519
"1106","42251304890000",1968135.462,311202.3333,2008-04-01,614622,12906707,39588782,8881211
"1107","42251304890000",1968135.462,311202.3333,2008-05-01,740235,13646942,39588782,9790992
"1108","42251304890000",1968135.462,311202.3333,2008-06-01,708053,14354995,39588782,9489076
"1109","42251304890000",1968135.462,311202.3333,2008-07-01,637412,14992407,39588782,9342850
"1110","42251304890000",1968135.462,311202.3333,2008-08-01,667815,15660222,39588782,9977335
"1111","42251304890000",1968135.462,311202.3333,2008-09-01,610235,16270457,39588782,9513587
"1112","42251304890000",1968135.462,311202.3333,2008-10-01,613480,16883937,39588782,9729575
"1113","42251304890000",1968135.462,311202.3333,2008-11-01,679323,17563260,39588782,10178583
"1114","42251304890000",1968135.462,311202.3333,2008-12-01,605056,18168316,39588782,9857864
"1115","42251304890000",1968135.462,311202.3333,2009-01-01,545391,18713707,39588782,9714975
"1116","42251304890000",1968135.462,311202.3333,2009-02-01,579987,19293694,39588782,9563848
"1117","42251304890000",1968135.462,311202.3333,2009-03-01,455793,19749487,39588782,10011008
"1118","42251304890000",1968135.462,311202.3333,2009-04-01,416542,20166029,39588782,8817835
"1119","42251304890000",1968135.462,311202.3333,2009-05-01,309827,20475856,39588782,9222275
"1120","42251304890000",1968135.462,311202.3333,2009-06-01,218930,20694786,39588782,8823798
"1121","42251304890000",1968135.462,311202.3333,2009-07-01,177071,20871857,39588782,9681047
"1122","42251304890000",1968135.462,311202.3333,2009-08-01,322780,21194637,39588782,10148823
"1123","42251304890000",1968135.462,311202.3333,2009-09-01,320232,21514869,39588782,9880092
"1124","42251304890000",1968135.462,311202.3333,2009-10-01,363019,21877888,39588782,10866851
"1125","42251304890000",1968135.462,311202.3333,2009-11-01,241688,22119576,39588782,10107974
"1126","42251304890000",1968135.462,311202.3333,2009-12-01,344579,22464155,39588782,10176315
"1127","42251304890000",1968135.462,311202.3333,2010-01-01,304110,22768265,39588782,10900701
"1128","42251304890000",1968135.462,311202.3333,2010-02-01,239846,23008111,39588782,10320596
"1129","42251304890000",1968135.462,311202.3333,2010-03-01,260468,23268579,39588782,12054256
"1130","42251304890000",1968135.462,311202.3333,2010-04-01,251540,23520119,39588782,11657482
"1131","42251304890000",1968135.462,311202.3333,2010-05-01,156885,23677004,39588782,12361540
"1132","42251304890000",1968135.462,311202.3333,2010-06-01,31572,23708576,39588782,11806317
"1133","42251304890000",1968135.462,311202.3333,2010-07-01,23169,23731745,39588782,13014429
"1134","42251304890000",1968135.462,311202.3333,2010-08-01,13091,23744836,39588782,12894731
"1135","42251304890000",1968135.462,311202.3333,2010-09-01,3882,23748718,39588782,13014299
"1136","42251304890000",1968135.462,311202.3333,2011-04-01,341430,24090148,39588782,13823700
"1137","42251304890000",1968135.462,311202.3333,2011-05-01,430668,24520816,39588782,14893483
"1138","42251304890000",1968135.462,311202.3333,2011-06-01,381063,24901879,39588782,13536023
"1139","42251304890000",1968135.462,311202.3333,2011-07-01,556523,25458402,39588782,14060435
"1140","42251304890000",1968135.462,311202.3333,2011-08-01,512444,25970846,39588782,13865713
"1141","42251304890000",1968135.462,311202.3333,2011-09-01,503464,26474310,39588782,13575950
"1142","42251304890000",1968135.462,311202.3333,2011-10-01,514605,26988915,39588782,14224672
"1143","42251304890000",1968135.462,311202.3333,2011-11-01,524072,27512987,39588782,14289379
"1144","42251304890000",1968135.462,311202.3333,2011-12-01,404260,27917247,39588782,14301497
"1145","42251304890000",1968135.462,311202.3333,2012-01-01,423180,28340427,39588782,14393197
"1146","42251304890000",1968135.462,311202.3333,2012-02-01,345599,28686026,39588782,13261820
"1147","42251304890000",1968135.462,311202.3333,2012-03-01,371529,29057555,39588782,14719295
"1148","42251304890000",1968135.462,311202.3333,2012-04-01,317708,29375263,39588782,13422939
"1149","42251304890000",1968135.462,311202.3333,2012-05-01,318325,29693588,39588782,13619470
"1150","42251304890000",1968135.462,311202.3333,2012-06-01,139241,29832829,39588782,12965656
"1151","42251304890000",1968135.462,311202.3333,2012-07-01,177680,30010509,39588782,13735215
"1152","42251304890000",1968135.462,311202.3333,2012-08-01,456922,30467431,39588782,13116786
"1153","42251304890000",1968135.462,311202.3333,2012-09-01,167243,30634674,39588782,12508392
"1154","42251304890000",1968135.462,311202.3333,2012-10-01,207279,30841953,39588782,12829987
"1155","42251304890000",1968135.462,311202.3333,2012-11-01,227384,31069337,39588782,11811242
"1156","42251304890000",1968135.462,311202.3333,2012-12-01,196269,31265606,39588782,12077125
"1157","42251304890000",1968135.462,311202.3333,2013-01-01,241339,31506945,39588782,12754328
"1158","42251304890000",1968135.462,311202.3333,2013-02-01,258495,31765440,39588782,11309584
"1159","42251304890000",1968135.462,311202.3333,2013-03-01,264211,32029651,39588782,12445227
"1160","42251304890000",1968135.462,311202.3333,2013-04-01,226874,32256525,39588782,11899338
"1161","42251304890000",1968135.462,311202.3333,2013-05-01,302142,32558667,39588782,11963242
"1162","42251304890000",1968135.462,311202.3333,2013-06-01,251343,32810010,39588782,11514151
"1163","42251304890000",1968135.462,311202.3333,2013-07-01,305441,33115451,39588782,12334827
"1164","42251304890000",1968135.462,311202.3333,2013-08-01,218231,33333682,39588782,12036527
"1165","42251304890000",1968135.462,311202.3333,2013-09-01,160571,33494253,39588782,11831621
"1166","42251304890000",1968135.462,311202.3333,2013-10-01,267258,33761511,39588782,11912081
"1167","42251304890000",1968135.462,311202.3333,2013-11-01,202454,33963965,39588782,11402351
"1168","42251304890000",1968135.462,311202.3333,2013-12-01,240750,34204715,39588782,10800800
"1169","42251304890000",1968135.462,311202.3333,2014-01-01,243191,34447906,39588782,11386084
"1170","42251304890000",1968135.462,311202.3333,2014-02-01,196510,34644416,39588782,9936683
"1171","42251304890000",1968135.462,311202.3333,2014-03-01,178764,34823180,39588782,12046987
"1172","42251304890000",1968135.462,311202.3333,2014-04-01,138150,34961330,39588782,11738869
"1173","42251304890000",1968135.462,311202.3333,2014-05-01,151762,35113092,39588782,12165041
"1174","42251304890000",1968135.462,311202.3333,2014-06-01,172139,35285231,39588782,11720072
"1175","42251304890000",1968135.462,311202.3333,2014-07-01,151207,35436438,39588782,11632955
"1176","42251304890000",1968135.462,311202.3333,2014-08-01,144960,35581398,39588782,11280396
"1177","42251304890000",1968135.462,311202.3333,2014-09-01,151776,35733174,39588782,10707843
"1178","42251304890000",1968135.462,311202.3333,2014-10-01,172529,35905703,39588782,11154961
"1179","42251304890000",1968135.462,311202.3333,2014-11-01,116939,36022642,39588782,11006198
"1180","42251304890000",1968135.462,311202.3333,2014-12-01,88140,36110782,39588782,11175048
"1181","42251304890000",1968135.462,311202.3333,2015-01-01,112562,36223344,39588782,11188192
"1182","42251304890000",1968135.462,311202.3333,2015-02-01,79190,36302534,39588782,9285348
"1183","42251304890000",1968135.462,311202.3333,2015-03-01,87171,36389705,39588782,11132951
"1184","42251304890000",1968135.462,311202.3333,2015-04-01,192453,36582158,39588782,10228970
"1185","42251304890000",1968135.462,311202.3333,2015-05-01,212252,36794410,39588782,10731832
"1186","42251304890000",1968135.462,311202.3333,2015-06-01,181634,36976044,39588782,10019178
"1187","42251304890000",1968135.462,311202.3333,2015-07-01,164450,37140494,39588782,9556838
"1188","42251304890000",1968135.462,311202.3333,2015-08-01,167078,37307572,39588782,9046352
"1189","42251304890000",1968135.462,311202.3333,2015-09-01,158810,37466382,39588782,8436833
"1190","42251304890000",1968135.462,311202.3333,2015-10-01,172529,37638911,39588782,8702949
"1191","42251304890000",1968135.462,311202.3333,2015-11-01,116939,37755850,39588782,8702391
"1192","42251304890000",1968135.462,311202.3333,2015-12-01,88140,37843990,39588782,8797617
"1193","42251304890000",1968135.462,311202.3333,2016-01-01,112582,37956572,39588782,8785697
"1194","42251304890000",1968135.462,311202.3333,2016-02-01,79190,38035762,39588782,8098391
"1195","42251304890000",1968135.462,311202.3333,2016-03-01,87171,38122933,39588782,8313445
"1196","42251304890000",1968135.462,311202.3333,2016-04-01,192453,38315386,39588782,8067410
"1197","42251304890000",1968135.462,311202.3333,2016-05-01,212252,38527638,39588782,8687363
"1198","42251304890000",1968135.462,311202.3333,2016-06-01,191634,38719272,39588782,8474598
"1199","42251304890000",1968135.462,311202.3333,2016-07-01,164450,38883722,39588782,8474294
"1200","42251304890000",1968135.462,311202.3333,2016-08-01,167078,39050800,39588782,8424724
"1201","42251304890000",1968135.462,311202.3333,2016-09-01,158810,39209610,39588782,7958587
"1202","42251304890000",1968135.462,311202.3333,2016-10-01,140331,39349941,39588782,7328643
"1203","42251304890000",1968135.462,311202.3333,2016-11-01,141098,39491039,39588782,7108192
"1204","42251304890000",1968135.462,311202.3333,2016-12-01,97743,39588782,39588782,7206177
"1205","42251305090000",1993552.317,235791.9031,2006-08-01,639286,639286,28812628,2512715
"1206","42251305090000",1993552.317,235791.9031,2006-09-01,733756,1373042,28812628,2773616
"1207","42251305090000",1993552.317,235791.9031,2006-10-01,712546,2085588,28812628,3124548
"1208","42251305090000",1993552.317,235791.9031,2006-11-01,670271,2755859,28812628,3240926
"1209","42251305090000",1993552.317,235791.9031,2006-12-01,591192,3347051,28812628,4484941
"1210","42251305090000",1993552.317,235791.9031,2007-01-01,505591,3852642,28812628,4380773
"1211","42251305090000",1993552.317,235791.9031,2007-02-01,554313,4406955,28812628,4175393
"1212","42251305090000",1993552.317,235791.9031,2007-03-01,576609,4983564,28812628,4620840
"1213","42251305090000",1993552.317,235791.9031,2007-04-01,554523,5538087,28812628,4876542
"1214","42251305090000",1993552.317,235791.9031,2007-05-01,744760,6282847,28812628,5347071
"1215","42251305090000",1993552.317,235791.9031,2007-06-01,673151,6955998,28812628,5055569
"1216","42251305090000",1993552.317,235791.9031,2007-07-01,660333,7616331,28812628,5639953
"1217","42251305090000",1993552.317,235791.9031,2007-08-01,624632,8240963,28812628,5967755
"1218","42251305090000",1993552.317,235791.9031,2007-09-01,428060,8669023,28812628,5629384
"1219","42251305090000",1993552.317,235791.9031,2007-10-01,461994,9131017,28812628,6483309
"1220","42251305090000",1993552.317,235791.9031,2007-11-01,550683,9681700,28812628,6157035
"1221","42251305090000",1993552.317,235791.9031,2007-12-01,409681,10091381,28812628,5777613
"1222","42251305090000",1993552.317,235791.9031,2008-01-01,248069,10339450,28812628,6452815
"1223","42251305090000",1993552.317,235791.9031,2008-02-01,319339,10658789,28812628,7775520
"1224","42251305090000",1993552.317,235791.9031,2008-03-01,411347,11070136,28812628,9152519
"1225","42251305090000",1993552.317,235791.9031,2008-04-01,295022,11365158,28812628,8881211
"1226","42251305090000",1993552.317,235791.9031,2008-05-01,350340,11715498,28812628,9790992
"1227","42251305090000",1993552.317,235791.9031,2008-06-01,243691,11959189,28812628,9489076
"1228","42251305090000",1993552.317,235791.9031,2008-07-01,280743,12239932,28812628,9342850
"1229","42251305090000",1993552.317,235791.9031,2008-08-01,317325,12557257,28812628,9977335
"1230","42251305090000",1993552.317,235791.9031,2008-09-01,230426,12787683,28812628,9513587
"1231","42251305090000",1993552.317,235791.9031,2008-10-01,290201,13077884,28812628,9729575
"1232","42251305090000",1993552.317,235791.9031,2008-11-01,386147,13464031,28812628,10178583
"1233","42251305090000",1993552.317,235791.9031,2008-12-01,189787,13653818,28812628,9857864
"1234","42251305090000",1993552.317,235791.9031,2009-01-01,311856,13965674,28812628,9714975
"1235","42251305090000",1993552.317,235791.9031,2009-02-01,234475,14200149,28812628,9563848
"1236","42251305090000",1993552.317,235791.9031,2009-03-01,139425,14339574,28812628,10011008
"1237","42251305090000",1993552.317,235791.9031,2009-04-01,85226,14424800,28812628,8817835
"1238","42251305090000",1993552.317,235791.9031,2009-05-01,90241,14515041,28812628,9222275
"1239","42251305090000",1993552.317,235791.9031,2011-05-01,2256,14517297,28812628,14893483
"1240","42251305090000",1993552.317,235791.9031,2011-06-01,39353,14556650,28812628,13536023
"1241","42251305090000",1993552.317,235791.9031,2011-07-01,95666,14652316,28812628,14060435
"1242","42251305090000",1993552.317,235791.9031,2011-08-01,138083,14790399,28812628,13865713
"1243","42251305090000",1993552.317,235791.9031,2011-09-01,77071,14867470,28812628,13575950
"1244","42251305090000",1993552.317,235791.9031,2011-10-01,382828,15250298,28812628,14224672
"1245","42251305090000",1993552.317,235791.9031,2011-11-01,311333,15561631,28812628,14289379
"1246","42251305090000",1993552.317,235791.9031,2011-12-01,298711,15860342,28812628,14301497
"1247","42251305090000",1993552.317,235791.9031,2012-01-01,129431,15989773,28812628,14393197
"1248","42251305090000",1993552.317,235791.9031,2012-02-01,214988,16204761,28812628,13261820
"1249","42251305090000",1993552.317,235791.9031,2012-03-01,216815,16421576,28812628,14719295
"1250","42251305090000",1993552.317,235791.9031,2012-04-01,231535,16653111,28812628,13422939
"1251","42251305090000",1993552.317,235791.9031,2012-05-01,171344,16824455,28812628,13619470
"1252","42251305090000",1993552.317,235791.9031,2012-06-01,241386,17065841,28812628,12965656
"1253","42251305090000",1993552.317,235791.9031,2012-07-01,304078,17369919,28812628,13735215
"1254","42251305090000",1993552.317,235791.9031,2012-08-01,242158,17612077,28812628,13116786
"1255","42251305090000",1993552.317,235791.9031,2012-09-01,262916,17874993,28812628,12508392
"1256","42251305090000",1993552.317,235791.9031,2012-10-01,329885,18204878,28812628,12829987
"1257","42251305090000",1993552.317,235791.9031,2012-11-01,423520,18628398,28812628,11811242
"1258","42251305090000",1993552.317,235791.9031,2012-12-01,457347,19085745,28812628,12077125
"1259","42251305090000",1993552.317,235791.9031,2013-01-01,356835,19442580,28812628,12754328
"1260","42251305090000",1993552.317,235791.9031,2013-02-01,221440,19664020,28812628,11309584
"1261","42251305090000",1993552.317,235791.9031,2013-03-01,228754,19892774,28812628,12445227
"1262","42251305090000",1993552.317,235791.9031,2013-04-01,227362,20120136,28812628,11899338
"1263","42251305090000",1993552.317,235791.9031,2013-05-01,268161,20388297,28812628,11963242
"1264","42251305090000",1993552.317,235791.9031,2013-06-01,171914,20560211,28812628,11514151
"1265","42251305090000",1993552.317,235791.9031,2013-07-01,238053,20798264,28812628,12334827
"1266","42251305090000",1993552.317,235791.9031,2013-08-01,218658,21016922,28812628,12036527
"1267","42251305090000",1993552.317,235791.9031,2013-09-01,93295,21110217,28812628,11831621
"1268","42251305090000",1993552.317,235791.9031,2013-10-01,139346,21249563,28812628,11912081
"1269","42251305090000",1993552.317,235791.9031,2013-11-01,160251,21409814,28812628,11402351
"1270","42251305090000",1993552.317,235791.9031,2013-12-01,184103,21593917,28812628,10800800
"1271","42251305090000",1993552.317,235791.9031,2014-01-01,319941,21913858,28812628,11386084
"1272","42251305090000",1993552.317,235791.9031,2014-02-01,230800,22144658,28812628,9936683
"1273","42251305090000",1993552.317,235791.9031,2014-03-01,164044,22308702,28812628,12046987
"1274","42251305090000",1993552.317,235791.9031,2014-04-01,191449,22500151,28812628,11738869
"1275","42251305090000",1993552.317,235791.9031,2014-05-01,214694,22714845,28812628,12165041
"1276","42251305090000",1993552.317,235791.9031,2014-06-01,219009,22933854,28812628,11720072
"1277","42251305090000",1993552.317,235791.9031,2014-07-01,155198,23089052,28812628,11632955
"1278","42251305090000",1993552.317,235791.9031,2014-08-01,129867,23218919,28812628,11280396
"1279","42251305090000",1993552.317,235791.9031,2014-09-01,134208,23353127,28812628,10707843
"1280","42251305090000",1993552.317,235791.9031,2014-10-01,169469,23522596,28812628,11154961
"1281","42251305090000",1993552.317,235791.9031,2014-11-01,121865,23644461,28812628,11006198
"1282","42251305090000",1993552.317,235791.9031,2014-12-01,139627,23784088,28812628,11175048
"1283","42251305090000",1993552.317,235791.9031,2015-01-01,194095,23978183,28812628,11188192
"1284","42251305090000",1993552.317,235791.9031,2015-02-01,234240,24212423,28812628,9285348
"1285","42251305090000",1993552.317,235791.9031,2015-03-01,275627,24488050,28812628,11132951
"1286","42251305090000",1993552.317,235791.9031,2015-04-01,170583,24658633,28812628,10228970
"1287","42251305090000",1993552.317,235791.9031,2015-05-01,286715,24945348,28812628,10731832
"1288","42251305090000",1993552.317,235791.9031,2015-06-01,138562,25083910,28812628,10019178
"1289","42251305090000",1993552.317,235791.9031,2015-07-01,163538,25247448,28812628,9556838
"1290","42251305090000",1993552.317,235791.9031,2015-08-01,196984,25444432,28812628,9046352
"1291","42251305090000",1993552.317,235791.9031,2015-09-01,150681,25595113,28812628,8436833
"1292","42251305090000",1993552.317,235791.9031,2015-10-01,156136,25751249,28812628,8702949
"1293","42251305090000",1993552.317,235791.9031,2015-11-01,145701,25896950,28812628,8702391
"1294","42251305090000",1993552.317,235791.9031,2015-12-01,117597,26014547,28812628,8797617
"1295","42251305090000",1993552.317,235791.9031,2016-01-01,141914,26156461,28812628,8785697
"1296","42251305090000",1993552.317,235791.9031,2016-02-01,223211,26379672,28812628,8098391
"1297","42251305090000",1993552.317,235791.9031,2016-03-01,112432,26492104,28812628,8313445
"1298","42251305090000",1993552.317,235791.9031,2016-04-01,133643,26625747,28812628,8067410
"1299","42251305090000",1993552.317,235791.9031,2016-05-01,98763,26724510,28812628,8687363
"1300","42251305090000",1993552.317,235791.9031,2016-06-01,147644,26872154,28812628,8474598
"1301","42251305090000",1993552.317,235791.9031,2016-07-01,121903,26994057,28812628,8474294
"1302","42251305090000",1993552.317,235791.9031,2016-08-01,109116,27103173,28812628,8424724
"1303","42251305090000",1993552.317,235791.9031,2016-09-01,97411,27200584,28812628,7958587
"1304","42251305090000",1993552.317,235791.9031,2016-10-01,194906,27395490,28812628,7328643
"1305","42251305090000",1993552.317,235791.9031,2016-11-01,91295,27486785,28812628,7108192
"1306","42251305090000",1993552.317,235791.9031,2016-12-01,104430,27591215,28812628,7206177
"1307","42251305090000",1993552.317,235791.9031,2017-01-01,123467,27714682,28812628,8191419
"1308","42251305090000",1993552.317,235791.9031,2017-02-01,136886,27851568,28812628,7284679
"1309","42251305090000",1993552.317,235791.9031,2017-03-01,121378,27972946,28812628,7793859
"1310","42251305090000",1993552.317,235791.9031,2017-04-01,100748,28073694,28812628,7558837
"1311","42251305090000",1993552.317,235791.9031,2017-05-01,227279,28300973,28812628,7868617
"1312","42251305090000",1993552.317,235791.9031,2017-06-01,145268,28446241,28812628,7593200
"1313","42251305090000",1993552.317,235791.9031,2017-07-01,128514,28574755,28812628,8034023
"1314","42251305090000",1993552.317,235791.9031,2017-08-01,126342,28701097,28812628,8259439
"1315","42251305090000",1993552.317,235791.9031,2017-09-01,111531,28812628,28812628,7833970
"1316","42251308340000",2113886.731,285063.0048,2006-08-01,236520,236520,37028883,2512715
"1317","42251308340000",2113886.731,285063.0048,2006-09-01,262680,499200,37028883,2773616
"1318","42251308340000",2113886.731,285063.0048,2006-10-01,135140,634340,37028883,3124548
"1319","42251308340000",2113886.731,285063.0048,2006-11-01,513397,1147737,37028883,3240926
"1320","42251308340000",2113886.731,285063.0048,2006-12-01,538858,1686595,37028883,4484941
"1321","42251308340000",2113886.731,285063.0048,2007-01-01,537836,2224431,37028883,4380773
"1322","42251308340000",2113886.731,285063.0048,2007-02-01,410994,2635425,37028883,4175393
"1323","42251308340000",2113886.731,285063.0048,2007-03-01,566766,3202191,37028883,4620840
"1324","42251308340000",2113886.731,285063.0048,2007-04-01,423559,3625750,37028883,4876542
"1325","42251308340000",2113886.731,285063.0048,2007-05-01,490434,4116184,37028883,5347071
"1326","42251308340000",2113886.731,285063.0048,2007-06-01,491679,4607863,37028883,5055569
"1327","42251308340000",2113886.731,285063.0048,2007-07-01,551343,5159206,37028883,5639953
"1328","42251308340000",2113886.731,285063.0048,2007-08-01,615921,5775127,37028883,5967755
"1329","42251308340000",2113886.731,285063.0048,2007-09-01,593104,6368231,37028883,5629384
"1330","42251308340000",2113886.731,285063.0048,2007-10-01,597603,6965834,37028883,6483309
"1331","42251308340000",2113886.731,285063.0048,2007-11-01,545307,7511141,37028883,6157035
"1332","42251308340000",2113886.731,285063.0048,2007-12-01,684147,8195288,37028883,5777613
"1333","42251308340000",2113886.731,285063.0048,2008-01-01,625358,8820646,37028883,6452815
"1334","42251308340000",2113886.731,285063.0048,2008-02-01,618402,9439048,37028883,7775520
"1335","42251308340000",2113886.731,285063.0048,2008-03-01,543654,9982702,37028883,9152519
"1336","42251308340000",2113886.731,285063.0048,2008-04-01,541583,10524285,37028883,8881211
"1337","42251308340000",2113886.731,285063.0048,2008-05-01,592875,11117160,37028883,9790992
"1338","42251308340000",2113886.731,285063.0048,2008-06-01,561835,11678995,37028883,9489076
"1339","42251308340000",2113886.731,285063.0048,2008-07-01,626516,12305511,37028883,9342850
"1340","42251308340000",2113886.731,285063.0048,2008-08-01,565293,12870804,37028883,9977335
"1341","42251308340000",2113886.731,285063.0048,2008-09-01,591506,13462310,37028883,9513587
"1342","42251308340000",2113886.731,285063.0048,2008-10-01,633416,14095726,37028883,9729575
"1343","42251308340000",2113886.731,285063.0048,2008-11-01,628745,14724471,37028883,10178583
"1344","42251308340000",2113886.731,285063.0048,2008-12-01,629550,15354021,37028883,9857864
"1345","42251308340000",2113886.731,285063.0048,2009-01-01,630803,15984824,37028883,9714975
"1346","42251308340000",2113886.731,285063.0048,2009-02-01,492376,16477200,37028883,9563848
"1347","42251308340000",2113886.731,285063.0048,2009-03-01,586791,17063991,37028883,10011008
"1348","42251308340000",2113886.731,285063.0048,2009-04-01,495936,17559927,37028883,8817835
"1349","42251308340000",2113886.731,285063.0048,2009-05-01,342835,17902762,37028883,9222275
"1350","42251308340000",2113886.731,285063.0048,2009-06-01,327909,18230671,37028883,8823798
"1351","42251308340000",2113886.731,285063.0048,2009-07-01,355922,18586593,37028883,9681047
"1352","42251308340000",2113886.731,285063.0048,2009-08-01,142707,18729300,37028883,10148823
"1353","42251308340000",2113886.731,285063.0048,2009-09-01,165812,18895112,37028883,9880092
"1354","42251308340000",2113886.731,285063.0048,2009-10-01,367929,19263041,37028883,10866851
"1355","42251308340000",2113886.731,285063.0048,2009-11-01,386934,19649975,37028883,10107974
"1356","42251308340000",2113886.731,285063.0048,2009-12-01,327516,19977491,37028883,10176315
"1357","42251308340000",2113886.731,285063.0048,2010-01-01,324055,20301546,37028883,10900701
"1358","42251308340000",2113886.731,285063.0048,2010-02-01,351408,20652954,37028883,10320596
"1359","42251308340000",2113886.731,285063.0048,2010-03-01,279847,20932801,37028883,12054256
"1360","42251308340000",2113886.731,285063.0048,2010-04-01,271776,21204577,37028883,11657482
"1361","42251308340000",2113886.731,285063.0048,2010-05-01,309986,21514563,37028883,12361540
"1362","42251308340000",2113886.731,285063.0048,2010-06-01,496351,22010914,37028883,11806317
"1363","42251308340000",2113886.731,285063.0048,2010-07-01,486065,22496979,37028883,13014429
"1364","42251308340000",2113886.731,285063.0048,2010-08-01,432950,22929929,37028883,12894731
"1365","42251308340000",2113886.731,285063.0048,2010-09-01,480783,23410712,37028883,13014299
"1366","42251308340000",2113886.731,285063.0048,2010-10-01,249952,23660664,37028883,11689154
"1367","42251308340000",2113886.731,285063.0048,2010-11-01,352693,24013357,37028883,11954124
"1368","42251308340000",2113886.731,285063.0048,2010-12-01,329613,24342970,37028883,12386935
"1369","42251308340000",2113886.731,285063.0048,2011-01-01,387028,24729998,37028883,12491622
"1370","42251308340000",2113886.731,285063.0048,2011-02-01,281751,25011749,37028883,10744516
"1371","42251308340000",2113886.731,285063.0048,2011-03-01,312963,25324712,37028883,13585658
"1372","42251308340000",2113886.731,285063.0048,2011-04-01,281846,25606558,37028883,13823700
"1373","42251308340000",2113886.731,285063.0048,2011-05-01,151770,25758328,37028883,14893483
"1374","42251308340000",2113886.731,285063.0048,2011-06-01,155829,25914157,37028883,13536023
"1375","42251308340000",2113886.731,285063.0048,2011-07-01,144938,26059095,37028883,14060435
"1376","42251308340000",2113886.731,285063.0048,2011-08-01,242225,26301320,37028883,13865713
"1377","42251308340000",2113886.731,285063.0048,2011-09-01,156469,26457789,37028883,13575950
"1378","42251308340000",2113886.731,285063.0048,2011-10-01,125804,26583593,37028883,14224672
"1379","42251308340000",2113886.731,285063.0048,2011-11-01,192680,26776273,37028883,14289379
"1380","42251308340000",2113886.731,285063.0048,2011-12-01,262685,27038958,37028883,14301497
"1381","42251308340000",2113886.731,285063.0048,2012-01-01,252320,27291278,37028883,14393197
"1382","42251308340000",2113886.731,285063.0048,2012-02-01,241392,27532670,37028883,13261820
"1383","42251308340000",2113886.731,285063.0048,2012-03-01,365984,27898654,37028883,14719295
"1384","42251308340000",2113886.731,285063.0048,2012-04-01,272546,28171200,37028883,13422939
"1385","42251308340000",2113886.731,285063.0048,2012-05-01,256781,28427981,37028883,13619470
"1386","42251308340000",2113886.731,285063.0048,2012-06-01,233268,28661249,37028883,12965656
"1387","42251308340000",2113886.731,285063.0048,2012-07-01,224191,28885440,37028883,13735215
"1388","42251308340000",2113886.731,285063.0048,2012-08-01,222765,29108205,37028883,13116786
"1389","42251308340000",2113886.731,285063.0048,2012-09-01,206182,29314387,37028883,12508392
"1390","42251308340000",2113886.731,285063.0048,2012-10-01,208435,29522822,37028883,12829987
"1391","42251308340000",2113886.731,285063.0048,2012-11-01,186275,29709097,37028883,11811242
"1392","42251308340000",2113886.731,285063.0048,2012-12-01,207268,29916365,37028883,12077125
"1393","42251308340000",2113886.731,285063.0048,2013-01-01,213222,30129587,37028883,12754328
"1394","42251308340000",2113886.731,285063.0048,2013-02-01,186109,30315696,37028883,11309584
"1395","42251308340000",2113886.731,285063.0048,2013-03-01,207592,30523288,37028883,12445227
"1396","42251308340000",2113886.731,285063.0048,2013-04-01,182618,30705906,37028883,11899338
"1397","42251308340000",2113886.731,285063.0048,2013-05-01,168714,30874620,37028883,11963242
"1398","42251308340000",2113886.731,285063.0048,2013-06-01,162389,31037009,37028883,11514151
"1399","42251308340000",2113886.731,285063.0048,2013-07-01,172239,31209248,37028883,12334827
"1400","42251308340000",2113886.731,285063.0048,2013-08-01,186585,31395833,37028883,12036527
"1401","42251308340000",2113886.731,285063.0048,2013-09-01,212422,31608255,37028883,11831621
"1402","42251308340000",2113886.731,285063.0048,2013-10-01,212727,31820982,37028883,11912081
"1403","42251308340000",2113886.731,285063.0048,2013-11-01,216027,32037009,37028883,11402351
"1404","42251308340000",2113886.731,285063.0048,2013-12-01,201476,32238485,37028883,10800800
"1405","42251308340000",2113886.731,285063.0048,2014-01-01,208634,32447119,37028883,11386084
"1406","42251308340000",2113886.731,285063.0048,2014-02-01,265454,32712573,37028883,9936683
"1407","42251308340000",2113886.731,285063.0048,2014-03-01,217736,32930309,37028883,12046987
"1408","42251308340000",2113886.731,285063.0048,2014-04-01,185181,33115490,37028883,11738869
"1409","42251308340000",2113886.731,285063.0048,2014-05-01,201637,33317127,37028883,12165041
"1410","42251308340000",2113886.731,285063.0048,2014-06-01,191209,33508336,37028883,11720072
"1411","42251308340000",2113886.731,285063.0048,2014-07-01,187229,33695565,37028883,11632955
"1412","42251308340000",2113886.731,285063.0048,2014-08-01,178547,33874112,37028883,11280396
"1413","42251308340000",2113886.731,285063.0048,2014-09-01,176746,34050858,37028883,10707843
"1414","42251308340000",2113886.731,285063.0048,2014-10-01,190408,34241266,37028883,11154961
"1415","42251308340000",2113886.731,285063.0048,2014-11-01,180338,34421604,37028883,11006198
"1416","42251308340000",2113886.731,285063.0048,2014-12-01,177005,34598609,37028883,11175048
"1417","42251308340000",2113886.731,285063.0048,2015-01-01,173081,34771690,37028883,11188192
"1418","42251308340000",2113886.731,285063.0048,2015-02-01,164154,34935844,37028883,9285348
"1419","42251308340000",2113886.731,285063.0048,2015-03-01,180107,35115951,37028883,11132951
"1420","42251308340000",2113886.731,285063.0048,2015-04-01,172775,35288726,37028883,10228970
"1421","42251308340000",2113886.731,285063.0048,2015-05-01,49183,35337909,37028883,10731832
"1422","42251308340000",2113886.731,285063.0048,2015-08-01,83780,35421689,37028883,9046352
"1423","42251308340000",2113886.731,285063.0048,2015-09-01,125109,35546798,37028883,8436833
"1424","42251308340000",2113886.731,285063.0048,2015-10-01,126902,35673700,37028883,8702949
"1425","42251308340000",2113886.731,285063.0048,2015-11-01,131696,35805396,37028883,8702391
"1426","42251308340000",2113886.731,285063.0048,2015-12-01,131658,35937054,37028883,8797617
"1427","42251308340000",2113886.731,285063.0048,2016-01-01,106232,36043286,37028883,8785697
"1428","42251308340000",2113886.731,285063.0048,2016-02-01,124348,36167634,37028883,8098391
"1429","42251308340000",2113886.731,285063.0048,2016-03-01,124393,36292027,37028883,8313445
"1430","42251308340000",2113886.731,285063.0048,2016-04-01,130575,36422602,37028883,8067410
"1431","42251308340000",2113886.731,285063.0048,2016-05-01,128606,36551208,37028883,8687363
"1432","42251308340000",2113886.731,285063.0048,2016-06-01,114124,36665332,37028883,8474598
"1433","42251308340000",2113886.731,285063.0048,2016-07-01,121460,36786792,37028883,8474294
"1434","42251308340000",2113886.731,285063.0048,2016-08-01,120666,36907458,37028883,8424724
"1435","42251308340000",2113886.731,285063.0048,2016-09-01,119833,37027291,37028883,7958587
"1436","42251308340000",2113886.731,285063.0048,2017-01-01,1592,37028883,37028883,8191419
"1437","42251308970000",2038435.754,259351.2822,2008-02-01,20287,20287,37759600,7775520
"1438","42251308970000",2038435.754,259351.2822,2008-03-01,517290,537577,37759600,9152519
"1439","42251308970000",2038435.754,259351.2822,2008-04-01,628734,1166311,37759600,8881211
"1440","42251308970000",2038435.754,259351.2822,2008-05-01,634668,1800979,37759600,9790992
"1441","42251308970000",2038435.754,259351.2822,2008-06-01,625428,2426407,37759600,9489076
"1442","42251308970000",2038435.754,259351.2822,2008-07-01,741905,3168312,37759600,9342850
"1443","42251308970000",2038435.754,259351.2822,2008-08-01,716102,3884414,37759600,9977335
"1444","42251308970000",2038435.754,259351.2822,2008-09-01,539678,4424092,37759600,9513587
"1445","42251308970000",2038435.754,259351.2822,2008-10-01,661547,5085639,37759600,9729575
"1446","42251308970000",2038435.754,259351.2822,2008-11-01,657852,5743491,37759600,10178583
"1447","42251308970000",2038435.754,259351.2822,2008-12-01,509364,6252855,37759600,9857864
"1448","42251308970000",2038435.754,259351.2822,2009-01-01,503370,6756225,37759600,9714975
"1449","42251308970000",2038435.754,259351.2822,2009-02-01,457269,7213494,37759600,9563848
"1450","42251308970000",2038435.754,259351.2822,2009-03-01,458956,7672450,37759600,10011008
"1451","42251308970000",2038435.754,259351.2822,2009-04-01,332496,8004946,37759600,8817835
"1452","42251308970000",2038435.754,259351.2822,2009-05-01,265317,8270263,37759600,9222275
"1453","42251308970000",2038435.754,259351.2822,2009-06-01,236826,8507089,37759600,8823798
"1454","42251308970000",2038435.754,259351.2822,2009-07-01,422847,8929936,37759600,9681047
"1455","42251308970000",2038435.754,259351.2822,2009-08-01,477258,9407194,37759600,10148823
"1456","42251308970000",2038435.754,259351.2822,2009-09-01,402757,9809951,37759600,9880092
"1457","42251308970000",2038435.754,259351.2822,2009-10-01,388600,10198551,37759600,10866851
"1458","42251308970000",2038435.754,259351.2822,2009-11-01,394189,10592740,37759600,10107974
"1459","42251308970000",2038435.754,259351.2822,2009-12-01,431283,11024023,37759600,10176315
"1460","42251308970000",2038435.754,259351.2822,2010-01-01,551982,11576005,37759600,10900701
"1461","42251308970000",2038435.754,259351.2822,2010-02-01,445519,12021524,37759600,10320596
"1462","42251308970000",2038435.754,259351.2822,2010-03-01,450722,12472246,37759600,12054256
"1463","42251308970000",2038435.754,259351.2822,2010-04-01,433008,12905254,37759600,11657482
"1464","42251308970000",2038435.754,259351.2822,2010-05-01,426212,13331466,37759600,12361540
"1465","42251308970000",2038435.754,259351.2822,2010-06-01,299767,13631233,37759600,11806317
"1466","42251308970000",2038435.754,259351.2822,2010-07-01,310812,13942045,37759600,13014429
"1467","42251308970000",2038435.754,259351.2822,2010-08-01,306449,14248494,37759600,12894731
"1468","42251308970000",2038435.754,259351.2822,2010-09-01,432431,14680925,37759600,13014299
"1469","42251308970000",2038435.754,259351.2822,2011-04-01,50291,14731216,37759600,13823700
"1470","42251308970000",2038435.754,259351.2822,2011-05-01,528544,15259760,37759600,14893483
"1471","42251308970000",2038435.754,259351.2822,2011-06-01,610653,15870413,37759600,13536023
"1472","42251308970000",2038435.754,259351.2822,2011-07-01,589883,16460296,37759600,14060435
"1473","42251308970000",2038435.754,259351.2822,2011-08-01,451833,16912129,37759600,13865713
"1474","42251308970000",2038435.754,259351.2822,2011-09-01,606672,17518801,37759600,13575950
"1475","42251308970000",2038435.754,259351.2822,2011-10-01,607836,18126637,37759600,14224672
"1476","42251308970000",2038435.754,259351.2822,2011-11-01,395966,18522603,37759600,14289379
"1477","42251308970000",2038435.754,259351.2822,2011-12-01,400914,18923517,37759600,14301497
"1478","42251308970000",2038435.754,259351.2822,2012-01-01,405368,19328885,37759600,14393197
"1479","42251308970000",2038435.754,259351.2822,2012-02-01,298891,19627776,37759600,13261820
"1480","42251308970000",2038435.754,259351.2822,2012-03-01,349416,19977192,37759600,14719295
"1481","42251308970000",2038435.754,259351.2822,2012-04-01,316044,20293236,37759600,13422939
"1482","42251308970000",2038435.754,259351.2822,2012-05-01,272759,20565995,37759600,13619470
"1483","42251308970000",2038435.754,259351.2822,2012-06-01,214796,20780791,37759600,12965656
"1484","42251308970000",2038435.754,259351.2822,2012-07-01,286015,21066806,37759600,13735215
"1485","42251308970000",2038435.754,259351.2822,2012-08-01,336647,21403453,37759600,13116786
"1486","42251308970000",2038435.754,259351.2822,2012-09-01,320592,21724045,37759600,12508392
"1487","42251308970000",2038435.754,259351.2822,2012-10-01,412800,22136845,37759600,12829987
"1488","42251308970000",2038435.754,259351.2822,2012-11-01,414242,22551087,37759600,11811242
"1489","42251308970000",2038435.754,259351.2822,2012-12-01,338587,22889674,37759600,12077125
"1490","42251308970000",2038435.754,259351.2822,2013-01-01,228146,23117820,37759600,12754328
"1491","42251308970000",2038435.754,259351.2822,2013-02-01,192756,23310576,37759600,11309584
"1492","42251308970000",2038435.754,259351.2822,2013-03-01,271173,23581749,37759600,12445227
"1493","42251308970000",2038435.754,259351.2822,2013-04-01,188296,23770045,37759600,11899338
"1494","42251308970000",2038435.754,259351.2822,2013-05-01,193889,23963934,37759600,11963242
"1495","42251308970000",2038435.754,259351.2822,2013-06-01,136275,24100209,37759600,11514151
"1496","42251308970000",2038435.754,259351.2822,2013-07-01,360668,24460877,37759600,12334827
"1497","42251308970000",2038435.754,259351.2822,2013-08-01,153204,24614081,37759600,12036527
"1498","42251308970000",2038435.754,259351.2822,2013-09-01,362190,24976271,37759600,11831621
"1499","42251308970000",2038435.754,259351.2822,2013-10-01,385670,25361941,37759600,11912081
"1500","42251308970000",2038435.754,259351.2822,2013-11-01,289938,25651879,37759600,11402351
"1501","42251308970000",2038435.754,259351.2822,2013-12-01,254251,25906130,37759600,10800800
"1502","42251308970000",2038435.754,259351.2822,2014-01-01,318080,26224210,37759600,11386084
"1503","42251308970000",2038435.754,259351.2822,2014-02-01,262784,26486994,37759600,9936683
"1504","42251308970000",2038435.754,259351.2822,2014-03-01,289767,26776761,37759600,12046987
"1505","42251308970000",2038435.754,259351.2822,2014-04-01,306339,27083100,37759600,11738869
"1506","42251308970000",2038435.754,259351.2822,2014-05-01,355782,27438882,37759600,12165041
"1507","42251308970000",2038435.754,259351.2822,2014-06-01,315735,27754617,37759600,11720072
"1508","42251308970000",2038435.754,259351.2822,2014-07-01,279785,28034402,37759600,11632955
"1509","42251308970000",2038435.754,259351.2822,2014-08-01,252439,28286841,37759600,11280396
"1510","42251308970000",2038435.754,259351.2822,2014-09-01,360339,28647180,37759600,10707843
"1511","42251308970000",2038435.754,259351.2822,2014-10-01,610372,29257552,37759600,11154961
"1512","42251308970000",2038435.754,259351.2822,2014-11-01,234466,29492018,37759600,11006198
"1513","42251308970000",2038435.754,259351.2822,2014-12-01,269700,29761718,37759600,11175048
"1514","42251308970000",2038435.754,259351.2822,2015-01-01,300140,30061858,37759600,11188192
"1515","42251308970000",2038435.754,259351.2822,2015-02-01,235292,30297150,37759600,9285348
"1516","42251308970000",2038435.754,259351.2822,2015-03-01,320926,30618076,37759600,11132951
"1517","42251308970000",2038435.754,259351.2822,2015-04-01,413913,31031989,37759600,10228970
"1518","42251308970000",2038435.754,259351.2822,2015-05-01,555913,31587902,37759600,10731832
"1519","42251308970000",2038435.754,259351.2822,2015-06-01,306578,31894480,37759600,10019178
"1520","42251308970000",2038435.754,259351.2822,2015-07-01,356858,32251338,37759600,9556838
"1521","42251308970000",2038435.754,259351.2822,2015-08-01,199831,32451169,37759600,9046352
"1522","42251308970000",2038435.754,259351.2822,2015-09-01,229662,32680831,37759600,8436833
"1523","42251308970000",2038435.754,259351.2822,2015-10-01,231195,32912026,37759600,8702949
"1524","42251308970000",2038435.754,259351.2822,2015-11-01,311313,33223339,37759600,8702391
"1525","42251308970000",2038435.754,259351.2822,2015-12-01,264525,33487864,37759600,8797617
"1526","42251308970000",2038435.754,259351.2822,2016-01-01,172937,33660801,37759600,8785697
"1527","42251308970000",2038435.754,259351.2822,2016-02-01,170140,33830941,37759600,8098391
"1528","42251308970000",2038435.754,259351.2822,2016-03-01,174134,34005075,37759600,8313445
"1529","42251308970000",2038435.754,259351.2822,2016-04-01,246035,34251110,37759600,8067410
"1530","42251308970000",2038435.754,259351.2822,2016-05-01,230542,34481652,37759600,8687363
"1531","42251308970000",2038435.754,259351.2822,2016-06-01,180360,34662012,37759600,8474598
"1532","42251308970000",2038435.754,259351.2822,2016-07-01,184108,34846120,37759600,8474294
"1533","42251308970000",2038435.754,259351.2822,2016-08-01,213043,35059163,37759600,8424724
"1534","42251308970000",2038435.754,259351.2822,2016-09-01,268338,35327501,37759600,7958587
"1535","42251308970000",2038435.754,259351.2822,2016-10-01,164123,35491624,37759600,7328643
"1536","42251308970000",2038435.754,259351.2822,2016-11-01,180823,35672447,37759600,7108192
"1537","42251308970000",2038435.754,259351.2822,2016-12-01,216343,35888790,37759600,7206177
"1538","42251308970000",2038435.754,259351.2822,2017-01-01,200589,36089379,37759600,8191419
"1539","42251308970000",2038435.754,259351.2822,2017-02-01,326048,36415427,37759600,7284679
"1540","42251308970000",2038435.754,259351.2822,2017-03-01,385269,36800696,37759600,7793859
"1541","42251308970000",2038435.754,259351.2822,2017-04-01,153847,36954543,37759600,7558837
"1542","42251308970000",2038435.754,259351.2822,2017-05-01,149118,37103661,37759600,7868617
"1543","42251308970000",2038435.754,259351.2822,2017-06-01,143751,37247412,37759600,7593200
"1544","42251308970000",2038435.754,259351.2822,2017-07-01,186380,37433792,37759600,8034023
"1545","42251308970000",2038435.754,259351.2822,2017-08-01,195690,37629482,37759600,8259439
"1546","42251308970000",2038435.754,259351.2822,2017-09-01,130118,37759600,37759600,7833970
"1547","42251310200000",2076408.582,281591.546,2006-12-01,288490,288490,32910257,4484941
"1548","42251310200000",2076408.582,281591.546,2007-01-01,112927,401417,32910257,4380773
"1549","42251310200000",2076408.582,281591.546,2007-02-01,193583,595000,32910257,4175393
"1550","42251310200000",2076408.582,281591.546,2007-03-01,245598,840598,32910257,4620840
"1551","42251310200000",2076408.582,281591.546,2007-04-01,241810,1082408,32910257,4876542
"1552","42251310200000",2076408.582,281591.546,2007-05-01,371331,1453739,32910257,5347071
"1553","42251310200000",2076408.582,281591.546,2007-06-01,351266,1805005,32910257,5055569
"1554","42251310200000",2076408.582,281591.546,2007-07-01,344034,2149039,32910257,5639953
"1555","42251310200000",2076408.582,281591.546,2007-08-01,360841,2509880,32910257,5967755
"1556","42251310200000",2076408.582,281591.546,2007-09-01,449824,2959704,32910257,5629384
"1557","42251310200000",2076408.582,281591.546,2007-10-01,467301,3427005,32910257,6483309
"1558","42251310200000",2076408.582,281591.546,2007-11-01,361769,3788774,32910257,6157035
"1559","42251310200000",2076408.582,281591.546,2008-01-01,639306,4428080,32910257,6452815
"1560","42251310200000",2076408.582,281591.546,2008-02-01,670659,5098739,32910257,7775520
"1561","42251310200000",2076408.582,281591.546,2008-03-01,716171,5814910,32910257,9152519
"1562","42251310200000",2076408.582,281591.546,2008-04-01,611534,6426444,32910257,8881211
"1563","42251310200000",2076408.582,281591.546,2008-05-01,531976,6958420,32910257,9790992
"1564","42251310200000",2076408.582,281591.546,2008-06-01,492242,7450662,32910257,9489076
"1565","42251310200000",2076408.582,281591.546,2008-07-01,58075,7508737,32910257,9342850
"1566","42251310200000",2076408.582,281591.546,2008-10-01,295590,7804327,32910257,9729575
"1567","42251310200000",2076408.582,281591.546,2008-11-01,399682,8204009,32910257,10178583
"1568","42251310200000",2076408.582,281591.546,2008-12-01,404518,8608527,32910257,9857864
"1569","42251310200000",2076408.582,281591.546,2009-01-01,413537,9022064,32910257,9714975
"1570","42251310200000",2076408.582,281591.546,2009-02-01,344509,9366573,32910257,9563848
"1571","42251310200000",2076408.582,281591.546,2009-03-01,391995,9758568,32910257,10011008
"1572","42251310200000",2076408.582,281591.546,2009-04-01,343119,10101687,32910257,8817835
"1573","42251310200000",2076408.582,281591.546,2009-05-01,406840,10508527,32910257,9222275
"1574","42251310200000",2076408.582,281591.546,2009-06-01,321807,10830334,32910257,8823798
"1575","42251310200000",2076408.582,281591.546,2009-07-01,457600,11287934,32910257,9681047
"1576","42251310200000",2076408.582,281591.546,2009-08-01,407708,11695642,32910257,10148823
"1577","42251310200000",2076408.582,281591.546,2009-09-01,222728,11918370,32910257,9880092
"1578","42251310200000",2076408.582,281591.546,2009-10-01,385977,12304347,32910257,10866851
"1579","42251310200000",2076408.582,281591.546,2009-11-01,345770,12650117,32910257,10107974
"1580","42251310200000",2076408.582,281591.546,2009-12-01,449376,13099493,32910257,10176315
"1581","42251310200000",2076408.582,281591.546,2010-01-01,507520,13607013,32910257,10900701
"1582","42251310200000",2076408.582,281591.546,2010-02-01,415654,14022667,32910257,10320596
"1583","42251310200000",2076408.582,281591.546,2010-03-01,552074,14574741,32910257,12054256
"1584","42251310200000",2076408.582,281591.546,2010-04-01,604364,15179105,32910257,11657482
"1585","42251310200000",2076408.582,281591.546,2010-05-01,296888,15475993,32910257,12361540
"1586","42251310200000",2076408.582,281591.546,2010-06-01,279556,15755549,32910257,11806317
"1587","42251310200000",2076408.582,281591.546,2010-07-01,527823,16283372,32910257,13014429
"1588","42251310200000",2076408.582,281591.546,2010-08-01,570565,16853937,32910257,12894731
"1589","42251310200000",2076408.582,281591.546,2010-09-01,499758,17353695,32910257,13014299
"1590","42251310200000",2076408.582,281591.546,2010-10-01,493010,17846705,32910257,11689154
"1591","42251310200000",2076408.582,281591.546,2010-11-01,310917,18157622,32910257,11954124
"1592","42251310200000",2076408.582,281591.546,2010-12-01,381330,18538952,32910257,12386935
"1593","42251310200000",2076408.582,281591.546,2011-01-01,385767,18924719,32910257,12491622
"1594","42251310200000",2076408.582,281591.546,2011-02-01,336765,19261484,32910257,10744516
"1595","42251310200000",2076408.582,281591.546,2011-03-01,401035,19662519,32910257,13585658
"1596","42251310200000",2076408.582,281591.546,2011-04-01,393187,20055706,32910257,13823700
"1597","42251310200000",2076408.582,281591.546,2011-05-01,594364,20650070,32910257,14893483
"1598","42251310200000",2076408.582,281591.546,2011-06-01,566375,21216445,32910257,13536023
"1599","42251310200000",2076408.582,281591.546,2011-07-01,510975,21727420,32910257,14060435
"1600","42251310200000",2076408.582,281591.546,2011-08-01,453567,22180987,32910257,13865713
"1601","42251310200000",2076408.582,281591.546,2011-09-01,222934,22403921,32910257,13575950
"1602","42251310200000",2076408.582,281591.546,2011-11-01,625260,23029181,32910257,14289379
"1603","42251310200000",2076408.582,281591.546,2011-12-01,643450,23672631,32910257,14301497
"1604","42251310200000",2076408.582,281591.546,2012-01-01,590976,24263607,32910257,14393197
"1605","42251310200000",2076408.582,281591.546,2012-02-01,549202,24812809,32910257,13261820
"1606","42251310200000",2076408.582,281591.546,2012-03-01,645105,25457914,32910257,14719295
"1607","42251310200000",2076408.582,281591.546,2012-04-01,597705,26055619,32910257,13422939
"1608","42251310200000",2076408.582,281591.546,2012-05-01,490703,26546322,32910257,13619470
"1609","42251310200000",2076408.582,281591.546,2012-06-01,426424,26972746,32910257,12965656
"1610","42251310200000",2076408.582,281591.546,2012-07-01,404772,27377518,32910257,13735215
"1611","42251310200000",2076408.582,281591.546,2012-08-01,328075,27705593,32910257,13116786
"1612","42251310200000",2076408.582,281591.546,2012-09-01,255701,27961294,32910257,12508392
"1613","42251310200000",2076408.582,281591.546,2012-10-01,244819,28206113,32910257,12829987
"1614","42251310200000",2076408.582,281591.546,2012-11-01,220194,28426307,32910257,11811242
"1615","42251310200000",2076408.582,281591.546,2012-12-01,183494,28609801,32910257,12077125
"1616","42251310200000",2076408.582,281591.546,2013-01-01,186780,28796581,32910257,12754328
"1617","42251310200000",2076408.582,281591.546,2013-02-01,187461,28984042,32910257,11309584
"1618","42251310200000",2076408.582,281591.546,2013-03-01,278572,29262614,32910257,12445227
"1619","42251310200000",2076408.582,281591.546,2013-04-01,293913,29556527,32910257,11899338
"1620","42251310200000",2076408.582,281591.546,2013-05-01,327856,29884383,32910257,11963242
"1621","42251310200000",2076408.582,281591.546,2013-06-01,273343,30157726,32910257,11514151
"1622","42251310200000",2076408.582,281591.546,2013-07-01,280710,30438436,32910257,12334827
"1623","42251310200000",2076408.582,281591.546,2013-08-01,286457,30724893,32910257,12036527
"1624","42251310200000",2076408.582,281591.546,2013-09-01,249862,30974755,32910257,11831621
"1625","42251310200000",2076408.582,281591.546,2013-10-01,271677,31246432,32910257,11912081
"1626","42251310200000",2076408.582,281591.546,2013-11-01,6168,31252600,32910257,11402351
"1627","42251310200000",2076408.582,281591.546,2015-12-01,59398,31311998,32910257,8797617
"1628","42251310200000",2076408.582,281591.546,2016-01-01,259401,31571399,32910257,8785697
"1629","42251310200000",2076408.582,281591.546,2016-02-01,283042,31854441,32910257,8098391
"1630","42251310200000",2076408.582,281591.546,2016-03-01,235501,32089942,32910257,8313445
"1631","42251310200000",2076408.582,281591.546,2016-04-01,170249,32260191,32910257,8067410
"1632","42251310200000",2076408.582,281591.546,2016-05-01,103991,32364182,32910257,8687363
"1633","42251310200000",2076408.582,281591.546,2016-06-01,109932,32474114,32910257,8474598
"1634","42251310200000",2076408.582,281591.546,2016-07-01,44518,32518632,32910257,8474294
"1635","42251310200000",2076408.582,281591.546,2016-12-01,2397,32521029,32910257,7206177
"1636","42251310200000",2076408.582,281591.546,2017-01-01,4858,32525887,32910257,8191419
"1637","42251310200000",2076408.582,281591.546,2017-02-01,32732,32558619,32910257,7284679
"1638","42251310200000",2076408.582,281591.546,2017-03-01,45478,32604097,32910257,7793859
"1639","42251310200000",2076408.582,281591.546,2017-04-01,55013,32659110,32910257,7558837
"1640","42251310200000",2076408.582,281591.546,2017-05-01,34723,32693833,32910257,7868617
"1641","42251310200000",2076408.582,281591.546,2017-06-01,33750,32727583,32910257,7593200
"1642","42251310200000",2076408.582,281591.546,2017-07-01,39065,32766648,32910257,8034023
"1643","42251310200000",2076408.582,281591.546,2017-08-01,34175,32800823,32910257,8259439
"1644","42251310200000",2076408.582,281591.546,2017-09-01,32845,32833668,32910257,7833970
"1645","42251310200000",2076408.582,281591.546,2017-10-01,32631,32866299,32910257,316623
"1646","42251310200000",2076408.582,281591.546,2017-11-01,43958,32910257,32910257,161172
"1647","42251310210000",2090185.956,258555.3346,2007-03-01,10893,10893,35032635,4620840
"1648","42251310210000",2090185.956,258555.3346,2007-04-01,66696,77589,35032635,4876542
"1649","42251310210000",2090185.956,258555.3346,2007-05-01,82660,160249,35032635,5347071
"1650","42251310210000",2090185.956,258555.3346,2007-06-01,68941,229190,35032635,5055569
"1651","42251310210000",2090185.956,258555.3346,2007-07-01,291955,521145,35032635,5639953
"1652","42251310210000",2090185.956,258555.3346,2007-08-01,332978,854123,35032635,5967755
"1653","42251310210000",2090185.956,258555.3346,2007-09-01,311777,1165900,35032635,5629384
"1654","42251310210000",2090185.956,258555.3346,2007-10-01,285388,1451288,35032635,6483309
"1655","42251310210000",2090185.956,258555.3346,2007-11-01,42960,1494248,35032635,6157035
"1656","42251310210000",2090185.956,258555.3346,2008-02-01,618387,2112635,35032635,7775520
"1657","42251310210000",2090185.956,258555.3346,2008-03-01,541511,2654146,35032635,9152519
"1658","42251310210000",2090185.956,258555.3346,2008-04-01,550711,3204857,35032635,8881211
"1659","42251310210000",2090185.956,258555.3346,2008-05-01,510538,3715395,35032635,9790992
"1660","42251310210000",2090185.956,258555.3346,2008-06-01,492506,4207901,35032635,9489076
"1661","42251310210000",2090185.956,258555.3346,2008-07-01,783455,4991356,35032635,9342850
"1662","42251310210000",2090185.956,258555.3346,2008-08-01,696688,5688044,35032635,9977335
"1663","42251310210000",2090185.956,258555.3346,2008-09-01,614198,6302242,35032635,9513587
"1664","42251310210000",2090185.956,258555.3346,2008-10-01,533041,6835283,35032635,9729575
"1665","42251310210000",2090185.956,258555.3346,2008-11-01,426389,7261672,35032635,10178583
"1666","42251310210000",2090185.956,258555.3346,2008-12-01,494675,7756347,35032635,9857864
"1667","42251310210000",2090185.956,258555.3346,2009-01-01,389523,8145870,35032635,9714975
"1668","42251310210000",2090185.956,258555.3346,2009-02-01,447965,8593835,35032635,9563848
"1669","42251310210000",2090185.956,258555.3346,2009-03-01,420846,9014681,35032635,10011008
"1670","42251310210000",2090185.956,258555.3346,2009-04-01,342509,9357190,35032635,8817835
"1671","42251310210000",2090185.956,258555.3346,2009-05-01,433777,9790967,35032635,9222275
"1672","42251310210000",2090185.956,258555.3346,2009-06-01,508176,10299143,35032635,8823798
"1673","42251310210000",2090185.956,258555.3346,2009-07-01,373836,10672979,35032635,9681047
"1674","42251310210000",2090185.956,258555.3346,2009-08-01,326098,10999077,35032635,10148823
"1675","42251310210000",2090185.956,258555.3346,2009-09-01,366456,11365533,35032635,9880092
"1676","42251310210000",2090185.956,258555.3346,2009-10-01,452215,11817748,35032635,10866851
"1677","42251310210000",2090185.956,258555.3346,2009-11-01,383698,12201446,35032635,10107974
"1678","42251310210000",2090185.956,258555.3346,2009-12-01,395643,12597089,35032635,10176315
"1679","42251310210000",2090185.956,258555.3346,2010-01-01,419343,13016432,35032635,10900701
"1680","42251310210000",2090185.956,258555.3346,2010-02-01,353403,13369835,35032635,10320596
"1681","42251310210000",2090185.956,258555.3346,2010-03-01,34200,13404035,35032635,12054256
"1682","42251310210000",2090185.956,258555.3346,2010-05-01,285589,13689624,35032635,12361540
"1683","42251310210000",2090185.956,258555.3346,2010-06-01,331528,14021152,35032635,11806317
"1684","42251310210000",2090185.956,258555.3346,2010-07-01,337383,14358535,35032635,13014429
"1685","42251310210000",2090185.956,258555.3346,2010-08-01,332445,14690980,35032635,12894731
"1686","42251310210000",2090185.956,258555.3346,2010-09-01,307366,14998346,35032635,13014299
"1687","42251310210000",2090185.956,258555.3346,2010-10-01,333137,15331483,35032635,11689154
"1688","42251310210000",2090185.956,258555.3346,2010-11-01,471228,15802711,35032635,11954124
"1689","42251310210000",2090185.956,258555.3346,2010-12-01,629525,16432236,35032635,12386935
"1690","42251310210000",2090185.956,258555.3346,2011-01-01,449177,16881413,35032635,12491622
"1691","42251310210000",2090185.956,258555.3346,2011-02-01,413780,17295193,35032635,10744516
"1692","42251310210000",2090185.956,258555.3346,2011-03-01,620063,17915256,35032635,13585658
"1693","42251310210000",2090185.956,258555.3346,2011-04-01,569183,18484439,35032635,13823700
"1694","42251310210000",2090185.956,258555.3346,2011-05-01,611334,19095773,35032635,14893483
"1695","42251310210000",2090185.956,258555.3346,2011-06-01,505082,19600855,35032635,13536023
"1696","42251310210000",2090185.956,258555.3346,2011-07-01,473595,20074450,35032635,14060435
"1697","42251310210000",2090185.956,258555.3346,2011-08-01,390582,20465032,35032635,13865713
"1698","42251310210000",2090185.956,258555.3346,2011-09-01,543745,21008777,35032635,13575950
"1699","42251310210000",2090185.956,258555.3346,2011-10-01,333137,21341914,35032635,14224672
"1700","42251310210000",2090185.956,258555.3346,2011-11-01,580675,21922589,35032635,14289379
"1701","42251310210000",2090185.956,258555.3346,2011-12-01,626776,22549365,35032635,14301497
"1702","42251310210000",2090185.956,258555.3346,2012-01-01,490527,23039892,35032635,14393197
"1703","42251310210000",2090185.956,258555.3346,2012-02-01,416046,23455938,35032635,13261820
"1704","42251310210000",2090185.956,258555.3346,2012-03-01,484650,23940588,35032635,14719295
"1705","42251310210000",2090185.956,258555.3346,2012-04-01,489156,24429744,35032635,13422939
"1706","42251310210000",2090185.956,258555.3346,2012-05-01,438362,24868106,35032635,13619470
"1707","42251310210000",2090185.956,258555.3346,2012-06-01,454462,25322568,35032635,12965656
"1708","42251310210000",2090185.956,258555.3346,2012-07-01,310545,25633113,35032635,13735215
"1709","42251310210000",2090185.956,258555.3346,2012-08-01,169638,25802751,35032635,13116786
"1710","42251310210000",2090185.956,258555.3346,2012-09-01,175668,25978419,35032635,12508392
"1711","42251310210000",2090185.956,258555.3346,2012-10-01,213104,26191523,35032635,12829987
"1712","42251310210000",2090185.956,258555.3346,2012-11-01,210715,26402238,35032635,11811242
"1713","42251310210000",2090185.956,258555.3346,2012-12-01,214873,26617111,35032635,12077125
"1714","42251310210000",2090185.956,258555.3346,2013-01-01,232886,26849997,35032635,12754328
"1715","42251310210000",2090185.956,258555.3346,2013-02-01,201022,27051019,35032635,11309584
"1716","42251310210000",2090185.956,258555.3346,2013-03-01,208736,27259755,35032635,12445227
"1717","42251310210000",2090185.956,258555.3346,2013-04-01,197139,27456894,35032635,11899338
"1718","42251310210000",2090185.956,258555.3346,2013-05-01,163606,27620500,35032635,11963242
"1719","42251310210000",2090185.956,258555.3346,2013-06-01,117007,27737507,35032635,11514151
"1720","42251310210000",2090185.956,258555.3346,2013-07-01,135616,27873123,35032635,12334827
"1721","42251310210000",2090185.956,258555.3346,2013-08-01,141481,28014604,35032635,12036527
"1722","42251310210000",2090185.956,258555.3346,2013-09-01,121308,28135912,35032635,11831621
"1723","42251310210000",2090185.956,258555.3346,2013-10-01,160189,28296101,35032635,11912081
"1724","42251310210000",2090185.956,258555.3346,2013-11-01,305306,28601407,35032635,11402351
"1725","42251310210000",2090185.956,258555.3346,2013-12-01,190487,28791894,35032635,10800800
"1726","42251310210000",2090185.956,258555.3346,2014-01-01,167461,28959355,35032635,11386084
"1727","42251310210000",2090185.956,258555.3346,2014-02-01,249092,29208447,35032635,9936683
"1728","42251310210000",2090185.956,258555.3346,2014-03-01,173264,29381711,35032635,12046987
"1729","42251310210000",2090185.956,258555.3346,2014-04-01,170508,29552219,35032635,11738869
"1730","42251310210000",2090185.956,258555.3346,2014-05-01,105185,29657404,35032635,12165041
"1731","42251310210000",2090185.956,258555.3346,2014-06-01,103801,29761205,35032635,11720072
"1732","42251310210000",2090185.956,258555.3346,2014-07-01,102904,29864109,35032635,11632955
"1733","42251310210000",2090185.956,258555.3346,2014-08-01,89254,29953363,35032635,11280396
"1734","42251310210000",2090185.956,258555.3346,2014-09-01,71056,30024419,35032635,10707843
"1735","42251310210000",2090185.956,258555.3346,2014-10-01,115700,30140119,35032635,11154961
"1736","42251310210000",2090185.956,258555.3346,2014-11-01,107188,30247307,35032635,11006198
"1737","42251310210000",2090185.956,258555.3346,2014-12-01,186657,30433964,35032635,11175048
"1738","42251310210000",2090185.956,258555.3346,2015-01-01,160864,30594828,35032635,11188192
"1739","42251310210000",2090185.956,258555.3346,2015-02-01,141287,30736115,35032635,9285348
"1740","42251310210000",2090185.956,258555.3346,2015-03-01,152827,30888942,35032635,11132951
"1741","42251310210000",2090185.956,258555.3346,2015-04-01,153149,31042091,35032635,10228970
"1742","42251310210000",2090185.956,258555.3346,2015-05-01,67770,31109861,35032635,10731832
"1743","42251310210000",2090185.956,258555.3346,2015-06-01,65847,31175708,35032635,10019178
"1744","42251310210000",2090185.956,258555.3346,2015-07-01,69599,31245307,35032635,9556838
"1745","42251310210000",2090185.956,258555.3346,2015-08-01,61791,31307098,35032635,9046352
"1746","42251310210000",2090185.956,258555.3346,2015-09-01,57366,31364464,35032635,8436833
"1747","42251310210000",2090185.956,258555.3346,2015-10-01,97157,31461621,35032635,8702949
"1748","42251310210000",2090185.956,258555.3346,2015-11-01,91947,31553568,35032635,8702391
"1749","42251310210000",2090185.956,258555.3346,2015-12-01,142087,31695655,35032635,8797617
"1750","42251310210000",2090185.956,258555.3346,2016-02-01,62360,31758015,35032635,8098391
"1751","42251310210000",2090185.956,258555.3346,2016-03-01,63034,31821049,35032635,8313445
"1752","42251310210000",2090185.956,258555.3346,2016-04-01,142998,31964047,35032635,8067410
"1753","42251310210000",2090185.956,258555.3346,2016-05-01,223120,32187167,35032635,8687363
"1754","42251310210000",2090185.956,258555.3346,2016-06-01,39038,32226205,35032635,8474598
"1755","42251310210000",2090185.956,258555.3346,2016-09-01,6910,32233115,35032635,7958587
"1756","42251310210000",2090185.956,258555.3346,2016-10-01,172401,32405516,35032635,7328643
"1757","42251310210000",2090185.956,258555.3346,2016-11-01,212479,32617995,35032635,7108192
"1758","42251310210000",2090185.956,258555.3346,2016-12-01,205481,32823476,35032635,7206177
"1759","42251310210000",2090185.956,258555.3346,2017-01-01,220762,33044238,35032635,8191419
"1760","42251310210000",2090185.956,258555.3346,2017-02-01,282467,33326705,35032635,7284679
"1761","42251310210000",2090185.956,258555.3346,2017-03-01,302734,33629439,35032635,7793859
"1762","42251310210000",2090185.956,258555.3346,2017-04-01,318026,33947465,35032635,7558837
"1763","42251310210000",2090185.956,258555.3346,2017-05-01,319652,34267117,35032635,7868617
"1764","42251310210000",2090185.956,258555.3346,2017-06-01,140863,34407980,35032635,7593200
"1765","42251310210000",2090185.956,258555.3346,2017-07-01,139063,34547043,35032635,8034023
"1766","42251310210000",2090185.956,258555.3346,2017-08-01,112683,34659726,35032635,8259439
"1767","42251310210000",2090185.956,258555.3346,2017-09-01,118806,34778532,35032635,7833970
"1768","42251310210000",2090185.956,258555.3346,2017-10-01,136889,34915421,35032635,316623
"1769","42251310210000",2090185.956,258555.3346,2017-11-01,117214,35032635,35032635,161172
"1770","42251313050000",2121132.876,309816.186,2008-01-01,54949,54949,21635380,6452815
"1771","42251313050000",2121132.876,309816.186,2008-02-01,386443,441392,21635380,7775520
"1772","42251313050000",2121132.876,309816.186,2008-03-01,619997,1061389,21635380,9152519
"1773","42251313050000",2121132.876,309816.186,2008-04-01,433899,1495288,21635380,8881211
"1774","42251313050000",2121132.876,309816.186,2008-05-01,599442,2094730,21635380,9790992
"1775","42251313050000",2121132.876,309816.186,2008-06-01,643522,2738252,21635380,9489076
"1776","42251313050000",2121132.876,309816.186,2008-07-01,594909,3333161,21635380,9342850
"1777","42251313050000",2121132.876,309816.186,2008-08-01,697590,4030751,21635380,9977335
"1778","42251313050000",2121132.876,309816.186,2008-09-01,575846,4606597,21635380,9513587
"1779","42251313050000",2121132.876,309816.186,2008-10-01,376617,4983214,21635380,9729575
"1780","42251313050000",2121132.876,309816.186,2008-11-01,287194,5270408,21635380,10178583
"1781","42251313050000",2121132.876,309816.186,2008-12-01,251148,5521556,21635380,9857864
"1782","42251313050000",2121132.876,309816.186,2009-01-01,324872,5846428,21635380,9714975
"1783","42251313050000",2121132.876,309816.186,2009-02-01,356507,6202935,21635380,9563848
"1784","42251313050000",2121132.876,309816.186,2009-03-01,256678,6459613,21635380,10011008
"1785","42251313050000",2121132.876,309816.186,2009-04-01,218856,6678469,21635380,8817835
"1786","42251313050000",2121132.876,309816.186,2009-05-01,344381,7022850,21635380,9222275
"1787","42251313050000",2121132.876,309816.186,2009-06-01,275905,7298755,21635380,8823798
"1788","42251313050000",2121132.876,309816.186,2009-07-01,208813,7507568,21635380,9681047
"1789","42251313050000",2121132.876,309816.186,2009-08-01,463695,7971263,21635380,10148823
"1790","42251313050000",2121132.876,309816.186,2009-09-01,386205,8357468,21635380,9880092
"1791","42251313050000",2121132.876,309816.186,2009-10-01,256446,8613914,21635380,10866851
"1792","42251313050000",2121132.876,309816.186,2009-11-01,402297,9016211,21635380,10107974
"1793","42251313050000",2121132.876,309816.186,2009-12-01,409813,9426024,21635380,10176315
"1794","42251313050000",2121132.876,309816.186,2010-01-01,370693,9796717,21635380,10900701
"1795","42251313050000",2121132.876,309816.186,2010-02-01,244560,10041277,21635380,10320596
"1796","42251313050000",2121132.876,309816.186,2010-03-01,286954,10328231,21635380,12054256
"1797","42251313050000",2121132.876,309816.186,2010-04-01,242644,10570875,21635380,11657482
"1798","42251313050000",2121132.876,309816.186,2010-05-01,228530,10799405,21635380,12361540
"1799","42251313050000",2121132.876,309816.186,2010-06-01,315969,11115374,21635380,11806317
"1800","42251313050000",2121132.876,309816.186,2010-07-01,433001,11548375,21635380,13014429
"1801","42251313050000",2121132.876,309816.186,2010-08-01,384787,11933162,21635380,12894731
"1802","42251313050000",2121132.876,309816.186,2010-09-01,348221,12281383,21635380,13014299
"1803","42251313050000",2121132.876,309816.186,2010-10-01,181086,12462469,21635380,11689154
"1804","42251313050000",2121132.876,309816.186,2010-11-01,270053,12732522,21635380,11954124
"1805","42251313050000",2121132.876,309816.186,2010-12-01,253967,12986489,21635380,12386935
"1806","42251313050000",2121132.876,309816.186,2011-01-01,233386,13219875,21635380,12491622
"1807","42251313050000",2121132.876,309816.186,2011-02-01,195269,13415144,21635380,10744516
"1808","42251313050000",2121132.876,309816.186,2011-03-01,225080,13640224,21635380,13585658
"1809","42251313050000",2121132.876,309816.186,2011-04-01,192713,13832937,21635380,13823700
"1810","42251313050000",2121132.876,309816.186,2011-05-01,326250,14159187,21635380,14893483
"1811","42251313050000",2121132.876,309816.186,2011-06-01,288501,14447688,21635380,13536023
"1812","42251313050000",2121132.876,309816.186,2011-07-01,316581,14764269,21635380,14060435
"1813","42251313050000",2121132.876,309816.186,2011-08-01,202069,14966338,21635380,13865713
"1814","42251313050000",2121132.876,309816.186,2011-09-01,248573,15214911,21635380,13575950
"1815","42251313050000",2121132.876,309816.186,2011-10-01,322260,15537171,21635380,14224672
"1816","42251313050000",2121132.876,309816.186,2011-11-01,245809,15782980,21635380,14289379
"1817","42251313050000",2121132.876,309816.186,2011-12-01,192571,15975551,21635380,14301497
"1818","42251313050000",2121132.876,309816.186,2012-01-01,181104,16156655,21635380,14393197
"1819","42251313050000",2121132.876,309816.186,2012-02-01,169539,16326194,21635380,13261820
"1820","42251313050000",2121132.876,309816.186,2012-03-01,185311,16511505,21635380,14719295
"1821","42251313050000",2121132.876,309816.186,2012-04-01,177219,16688724,21635380,13422939
"1822","42251313050000",2121132.876,309816.186,2012-05-01,176758,16865482,21635380,13619470
"1823","42251313050000",2121132.876,309816.186,2012-06-01,164205,17029687,21635380,12965656
"1824","42251313050000",2121132.876,309816.186,2012-07-01,169426,17199113,21635380,13735215
"1825","42251313050000",2121132.876,309816.186,2012-08-01,166594,17365707,21635380,13116786
"1826","42251313050000",2121132.876,309816.186,2012-09-01,161089,17526796,21635380,12508392
"1827","42251313050000",2121132.876,309816.186,2012-10-01,157856,17684652,21635380,12829987
"1828","42251313050000",2121132.876,309816.186,2012-11-01,145161,17829813,21635380,11811242
"1829","42251313050000",2121132.876,309816.186,2012-12-01,154894,17984707,21635380,12077125
"1830","42251313050000",2121132.876,309816.186,2013-01-01,145531,18130238,21635380,12754328
"1831","42251313050000",2121132.876,309816.186,2013-02-01,130161,18260399,21635380,11309584
"1832","42251313050000",2121132.876,309816.186,2013-03-01,149431,18409830,21635380,12445227
"1833","42251313050000",2121132.876,309816.186,2013-04-01,150515,18560345,21635380,11899338
"1834","42251313050000",2121132.876,309816.186,2013-05-01,153026,18713371,21635380,11963242
"1835","42251313050000",2121132.876,309816.186,2013-06-01,143597,18856968,21635380,11514151
"1836","42251313050000",2121132.876,309816.186,2013-07-01,146396,19003364,21635380,12334827
"1837","42251313050000",2121132.876,309816.186,2013-08-01,146863,19150227,21635380,12036527
"1838","42251313050000",2121132.876,309816.186,2013-09-01,139857,19290084,21635380,11831621
"1839","42251313050000",2121132.876,309816.186,2013-10-01,138247,19428331,21635380,11912081
"1840","42251313050000",2121132.876,309816.186,2013-11-01,114785,19543116,21635380,11402351
"1841","42251313050000",2121132.876,309816.186,2013-12-01,120472,19663588,21635380,10800800
"1842","42251313050000",2121132.876,309816.186,2014-01-01,119852,19783440,21635380,11386084
"1843","42251313050000",2121132.876,309816.186,2014-02-01,108897,19892337,21635380,9936683
"1844","42251313050000",2121132.876,309816.186,2014-03-01,131020,20023357,21635380,12046987
"1845","42251313050000",2121132.876,309816.186,2014-04-01,168627,20191984,21635380,11738869
"1846","42251313050000",2121132.876,309816.186,2014-05-01,139028,20331012,21635380,12165041
"1847","42251313050000",2121132.876,309816.186,2014-06-01,129745,20460757,21635380,11720072
"1848","42251313050000",2121132.876,309816.186,2014-07-01,127133,20587890,21635380,11632955
"1849","42251313050000",2121132.876,309816.186,2014-08-01,124867,20712757,21635380,11280396
"1850","42251313050000",2121132.876,309816.186,2014-09-01,117521,20830278,21635380,10707843
"1851","42251313050000",2121132.876,309816.186,2014-10-01,37760,20868038,21635380,11154961
"1852","42251313050000",2121132.876,309816.186,2014-11-01,126703,20994741,21635380,11006198
"1853","42251313050000",2121132.876,309816.186,2014-12-01,127772,21122513,21635380,11175048
"1854","42251313050000",2121132.876,309816.186,2015-01-01,129140,21251653,21635380,11188192
"1855","42251313050000",2121132.876,309816.186,2015-02-01,109113,21360766,21635380,9285348
"1856","42251313050000",2121132.876,309816.186,2015-03-01,120661,21481427,21635380,11132951
"1857","42251313050000",2121132.876,309816.186,2015-04-01,119927,21601354,21635380,10228970
"1858","42251313050000",2121132.876,309816.186,2015-05-01,33769,21635123,21635380,10731832
"1859","42251313050000",2121132.876,309816.186,2015-06-01,25,21635148,21635380,10019178
"1860","42251313050000",2121132.876,309816.186,2015-07-01,31,21635179,21635380,9556838
"1861","42251313050000",2121132.876,309816.186,2015-08-01,181,21635360,21635380,9046352
"1862","42251313050000",2121132.876,309816.186,2015-09-01,9,21635369,21635380,8436833
"1863","42251313050000",2121132.876,309816.186,2015-10-01,1,21635370,21635380,8702949
"1864","42251313050000",2121132.876,309816.186,2016-04-01,1,21635371,21635380,8067410
"1865","42251313050000",2121132.876,309816.186,2016-05-01,3,21635374,21635380,8687363
"1866","42251313050000",2121132.876,309816.186,2016-06-01,2,21635376,21635380,8474598
"1867","42251313050000",2121132.876,309816.186,2016-07-01,1,21635377,21635380,8474294
"1868","42251313050000",2121132.876,309816.186,2016-08-01,2,21635379,21635380,8424724
"1869","42251313050000",2121132.876,309816.186,2016-09-01,1,21635380,21635380,7958587
"1870","42251320590000",2022697.862,315589.1804,2010-02-01,316762,316762,33237934,10320596
"1871","42251320590000",2022697.862,315589.1804,2010-03-01,605127,921889,33237934,12054256
"1872","42251320590000",2022697.862,315589.1804,2010-04-01,418262,1340151,33237934,11657482
"1873","42251320590000",2022697.862,315589.1804,2010-05-01,398542,1738693,33237934,12361540
"1874","42251320590000",2022697.862,315589.1804,2010-06-01,383175,2121868,33237934,11806317
"1875","42251320590000",2022697.862,315589.1804,2010-07-01,407573,2529441,33237934,13014429
"1876","42251320590000",2022697.862,315589.1804,2010-08-01,411455,2940896,33237934,12894731
"1877","42251320590000",2022697.862,315589.1804,2010-09-01,530210,3471106,33237934,13014299
"1878","42251320590000",2022697.862,315589.1804,2010-10-01,479612,3950718,33237934,11689154
"1879","42251320590000",2022697.862,315589.1804,2010-11-01,544436,4495154,33237934,11954124
"1880","42251320590000",2022697.862,315589.1804,2010-12-01,528763,5023917,33237934,12386935
"1881","42251320590000",2022697.862,315589.1804,2011-01-01,509801,5533718,33237934,12491622
"1882","42251320590000",2022697.862,315589.1804,2011-02-01,407628,5941346,33237934,10744516
"1883","42251320590000",2022697.862,315589.1804,2011-03-01,599703,6541049,33237934,13585658
"1884","42251320590000",2022697.862,315589.1804,2011-04-01,507449,7048498,33237934,13823700
"1885","42251320590000",2022697.862,315589.1804,2011-07-01,202101,7250599,33237934,14060435
"1886","42251320590000",2022697.862,315589.1804,2011-08-01,404259,7654858,33237934,13865713
"1887","42251320590000",2022697.862,315589.1804,2011-09-01,365718,8020576,33237934,13575950
"1888","42251320590000",2022697.862,315589.1804,2011-10-01,465571,8486147,33237934,14224672
"1889","42251320590000",2022697.862,315589.1804,2011-11-01,506705,8992852,33237934,14289379
"1890","42251320590000",2022697.862,315589.1804,2011-12-01,502973,9495825,33237934,14301497
"1891","42251320590000",2022697.862,315589.1804,2012-01-01,478276,9974101,33237934,14393197
"1892","42251320590000",2022697.862,315589.1804,2012-02-01,425308,10399409,33237934,13261820
"1893","42251320590000",2022697.862,315589.1804,2012-03-01,429382,10828791,33237934,14719295
"1894","42251320590000",2022697.862,315589.1804,2012-04-01,375807,11204598,33237934,13422939
"1895","42251320590000",2022697.862,315589.1804,2012-05-01,490107,11694705,33237934,13619470
"1896","42251320590000",2022697.862,315589.1804,2012-06-01,457523,12152228,33237934,12965656
"1897","42251320590000",2022697.862,315589.1804,2012-07-01,438272,12590500,33237934,13735215
"1898","42251320590000",2022697.862,315589.1804,2012-08-01,457582,13048082,33237934,13116786
"1899","42251320590000",2022697.862,315589.1804,2012-09-01,379438,13427520,33237934,12508392
"1900","42251320590000",2022697.862,315589.1804,2012-10-01,352640,13780160,33237934,12829987
"1901","42251320590000",2022697.862,315589.1804,2012-11-01,297211,14077371,33237934,11811242
"1902","42251320590000",2022697.862,315589.1804,2012-12-01,297196,14374567,33237934,12077125
"1903","42251320590000",2022697.862,315589.1804,2013-01-01,337521,14712088,33237934,12754328
"1904","42251320590000",2022697.862,315589.1804,2013-02-01,344937,15057025,33237934,11309584
"1905","42251320590000",2022697.862,315589.1804,2013-03-01,335454,15392479,33237934,12445227
"1906","42251320590000",2022697.862,315589.1804,2013-04-01,345493,15737972,33237934,11899338
"1907","42251320590000",2022697.862,315589.1804,2013-05-01,349831,16087803,33237934,11963242
"1908","42251320590000",2022697.862,315589.1804,2013-06-01,465198,16553001,33237934,11514151
"1909","42251320590000",2022697.862,315589.1804,2013-07-01,479991,17032992,33237934,12334827
"1910","42251320590000",2022697.862,315589.1804,2013-08-01,289880,17322872,33237934,12036527
"1911","42251320590000",2022697.862,315589.1804,2013-09-01,263661,17586533,33237934,11831621
"1912","42251320590000",2022697.862,315589.1804,2013-10-01,325682,17912215,33237934,11912081
"1913","42251320590000",2022697.862,315589.1804,2013-11-01,252794,18165009,33237934,11402351
"1914","42251320590000",2022697.862,315589.1804,2013-12-01,217927,18382936,33237934,10800800
"1915","42251320590000",2022697.862,315589.1804,2014-01-01,180186,18563122,33237934,11386084
"1916","42251320590000",2022697.862,315589.1804,2014-02-01,365432,18928554,33237934,9936683
"1917","42251320590000",2022697.862,315589.1804,2014-03-01,488913,19417467,33237934,12046987
"1918","42251320590000",2022697.862,315589.1804,2014-04-01,435297,19852764,33237934,11738869
"1919","42251320590000",2022697.862,315589.1804,2014-05-01,455578,20308342,33237934,12165041
"1920","42251320590000",2022697.862,315589.1804,2014-06-01,346633,20654975,33237934,11720072
"1921","42251320590000",2022697.862,315589.1804,2014-07-01,432196,21087171,33237934,11632955
"1922","42251320590000",2022697.862,315589.1804,2014-08-01,369048,21456219,33237934,11280396
"1923","42251320590000",2022697.862,315589.1804,2014-09-01,355140,21811359,33237934,10707843
"1924","42251320590000",2022697.862,315589.1804,2014-10-01,386069,22197428,33237934,11154961
"1925","42251320590000",2022697.862,315589.1804,2014-11-01,322898,22520326,33237934,11006198
"1926","42251320590000",2022697.862,315589.1804,2014-12-01,391681,22912007,33237934,11175048
"1927","42251320590000",2022697.862,315589.1804,2015-01-01,378959,23290966,33237934,11188192
"1928","42251320590000",2022697.862,315589.1804,2015-02-01,286614,23577580,33237934,9285348
"1929","42251320590000",2022697.862,315589.1804,2015-03-01,372291,23949871,33237934,11132951
"1930","42251320590000",2022697.862,315589.1804,2015-04-01,216654,24166525,33237934,10228970
"1931","42251320590000",2022697.862,315589.1804,2015-05-01,257764,24424289,33237934,10731832
"1932","42251320590000",2022697.862,315589.1804,2015-06-01,247765,24672054,33237934,10019178
"1933","42251320590000",2022697.862,315589.1804,2015-07-01,292753,24964807,33237934,9556838
"1934","42251320590000",2022697.862,315589.1804,2015-08-01,265637,25230444,33237934,9046352
"1935","42251320590000",2022697.862,315589.1804,2015-09-01,258544,25488988,33237934,8436833
"1936","42251320590000",2022697.862,315589.1804,2015-10-01,237487,25726475,33237934,8702949
"1937","42251320590000",2022697.862,315589.1804,2015-11-01,226945,25953420,33237934,8702391
"1938","42251320590000",2022697.862,315589.1804,2015-12-01,221702,26175122,33237934,8797617
"1939","42251320590000",2022697.862,315589.1804,2016-01-01,193792,26368914,33237934,8785697
"1940","42251320590000",2022697.862,315589.1804,2016-02-01,237298,26606212,33237934,8098391
"1941","42251320590000",2022697.862,315589.1804,2016-03-01,343092,26949304,33237934,8313445
"1942","42251320590000",2022697.862,315589.1804,2016-04-01,400415,27349719,33237934,8067410
"1943","42251320590000",2022697.862,315589.1804,2016-05-01,399537,27749256,33237934,8687363
"1944","42251320590000",2022697.862,315589.1804,2016-06-01,367280,28116536,33237934,8474598
"1945","42251320590000",2022697.862,315589.1804,2016-07-01,370645,28487181,33237934,8474294
"1946","42251320590000",2022697.862,315589.1804,2016-08-01,381365,28868546,33237934,8424724
"1947","42251320590000",2022697.862,315589.1804,2016-09-01,163175,29031721,33237934,7958587
"1948","42251320590000",2022697.862,315589.1804,2016-10-01,377565,29409286,33237934,7328643
"1949","42251320590000",2022697.862,315589.1804,2016-11-01,360665,29769951,33237934,7108192
"1950","42251320590000",2022697.862,315589.1804,2016-12-01,221031,29990982,33237934,7206177
"1951","42251320590000",2022697.862,315589.1804,2017-01-01,363899,30354881,33237934,8191419
"1952","42251320590000",2022697.862,315589.1804,2017-02-01,336586,30691467,33237934,7284679
"1953","42251320590000",2022697.862,315589.1804,2017-03-01,376734,31068201,33237934,7793859
"1954","42251320590000",2022697.862,315589.1804,2017-04-01,390294,31458495,33237934,7558837
"1955","42251320590000",2022697.862,315589.1804,2017-05-01,388886,31847381,33237934,7868617
"1956","42251320590000",2022697.862,315589.1804,2017-06-01,368435,32215816,33237934,7593200
"1957","42251320590000",2022697.862,315589.1804,2017-07-01,361142,32576958,33237934,8034023
"1958","42251320590000",2022697.862,315589.1804,2017-08-01,350461,32927419,33237934,8259439
"1959","42251320590000",2022697.862,315589.1804,2017-09-01,310515,33237934,33237934,7833970
"1960","42251323270000",2076397.24,283785.1739,2008-05-01,90899,90899,54084539,9790992
"1961","42251323270000",2076397.24,283785.1739,2008-06-01,179986,270885,54084539,9489076
"1962","42251323270000",2076397.24,283785.1739,2008-07-01,109820,380705,54084539,9342850
"1963","42251323270000",2076397.24,283785.1739,2008-08-01,236982,617687,54084539,9977335
"1964","42251323270000",2076397.24,283785.1739,2008-09-01,285508,903195,54084539,9513587
"1965","42251323270000",2076397.24,283785.1739,2008-10-01,237938,1141133,54084539,9729575
"1966","42251323270000",2076397.24,283785.1739,2008-11-01,263450,1404583,54084539,10178583
"1967","42251323270000",2076397.24,283785.1739,2008-12-01,331105,1735688,54084539,9857864
"1968","42251323270000",2076397.24,283785.1739,2009-01-01,330057,2065745,54084539,9714975
"1969","42251323270000",2076397.24,283785.1739,2009-02-01,347790,2413535,54084539,9563848
"1970","42251323270000",2076397.24,283785.1739,2009-03-01,310388,2723923,54084539,10011008
"1971","42251323270000",2076397.24,283785.1739,2009-04-01,275888,2999811,54084539,8817835
"1972","42251323270000",2076397.24,283785.1739,2009-05-01,337160,3336971,54084539,9222275
"1973","42251323270000",2076397.24,283785.1739,2009-06-01,291456,3628427,54084539,8823798
"1974","42251323270000",2076397.24,283785.1739,2009-07-01,342975,3971402,54084539,9681047
"1975","42251323270000",2076397.24,283785.1739,2009-08-01,405032,4376434,54084539,10148823
"1976","42251323270000",2076397.24,283785.1739,2009-09-01,384752,4761186,54084539,9880092
"1977","42251323270000",2076397.24,283785.1739,2009-10-01,474479,5235665,54084539,10866851
"1978","42251323270000",2076397.24,283785.1739,2009-11-01,542942,5778607,54084539,10107974
"1979","42251323270000",2076397.24,283785.1739,2009-12-01,543924,6322531,54084539,10176315
"1980","42251323270000",2076397.24,283785.1739,2010-01-01,426208,6748739,54084539,10900701
"1981","42251323270000",2076397.24,283785.1739,2010-02-01,436927,7185666,54084539,10320596
"1982","42251323270000",2076397.24,283785.1739,2010-03-01,582913,7768579,54084539,12054256
"1983","42251323270000",2076397.24,283785.1739,2010-04-01,526382,8294961,54084539,11657482
"1984","42251323270000",2076397.24,283785.1739,2010-05-01,528483,8823444,54084539,12361540
"1985","42251323270000",2076397.24,283785.1739,2010-06-01,536103,9359547,54084539,11806317
"1986","42251323270000",2076397.24,283785.1739,2010-07-01,582392,9941939,54084539,13014429
"1987","42251323270000",2076397.24,283785.1739,2010-08-01,550021,10491960,54084539,12894731
"1988","42251323270000",2076397.24,283785.1739,2010-09-01,291350,10783310,54084539,13014299
"1989","42251323270000",2076397.24,283785.1739,2010-10-01,620562,11403872,54084539,11689154
"1990","42251323270000",2076397.24,283785.1739,2010-11-01,606251,12010123,54084539,11954124
"1991","42251323270000",2076397.24,283785.1739,2010-12-01,634003,12644126,54084539,12386935
"1992","42251323270000",2076397.24,283785.1739,2011-01-01,482621,13126747,54084539,12491622
"1993","42251323270000",2076397.24,283785.1739,2011-02-01,481415,13608162,54084539,10744516
"1994","42251323270000",2076397.24,283785.1739,2011-03-01,537349,14145511,54084539,13585658
"1995","42251323270000",2076397.24,283785.1739,2011-04-01,513349,14658860,54084539,13823700
"1996","42251323270000",2076397.24,283785.1739,2011-05-01,608668,15267528,54084539,14893483
"1997","42251323270000",2076397.24,283785.1739,2011-06-01,535780,15803308,54084539,13536023
"1998","42251323270000",2076397.24,283785.1739,2011-07-01,529440,16332748,54084539,14060435
"1999","42251323270000",2076397.24,283785.1739,2011-08-01,498214,16830962,54084539,13865713
"2000","42251323270000",2076397.24,283785.1739,2011-09-01,525098,17356060,54084539,13575950
"2001","42251323270000",2076397.24,283785.1739,2011-10-01,485929,17841989,54084539,14224672
"2002","42251323270000",2076397.24,283785.1739,2011-11-01,127396,17969385,54084539,14289379
"2003","42251323270000",2076397.24,283785.1739,2011-12-01,269688,18239073,54084539,14301497
"2004","42251323270000",2076397.24,283785.1739,2012-01-01,488609,18727682,54084539,14393197
"2005","42251323270000",2076397.24,283785.1739,2012-02-01,454167,19181849,54084539,13261820
"2006","42251323270000",2076397.24,283785.1739,2012-03-01,503957,19685806,54084539,14719295
"2007","42251323270000",2076397.24,283785.1739,2012-04-01,399607,20085413,54084539,13422939
"2008","42251323270000",2076397.24,283785.1739,2012-05-01,390492,20475905,54084539,13619470
"2009","42251323270000",2076397.24,283785.1739,2012-06-01,439576,20915481,54084539,12965656
"2010","42251323270000",2076397.24,283785.1739,2012-07-01,428210,21343691,54084539,13735215
"2011","42251323270000",2076397.24,283785.1739,2012-08-01,247964,21591655,54084539,13116786
"2012","42251323270000",2076397.24,283785.1739,2012-09-01,299196,21890851,54084539,12508392
"2013","42251323270000",2076397.24,283785.1739,2012-10-01,583147,22473998,54084539,12829987
"2014","42251323270000",2076397.24,283785.1739,2012-11-01,669820,23143818,54084539,11811242
"2015","42251323270000",2076397.24,283785.1739,2012-12-01,591780,23735598,54084539,12077125
"2016","42251323270000",2076397.24,283785.1739,2013-01-01,605150,24340748,54084539,12754328
"2017","42251323270000",2076397.24,283785.1739,2013-02-01,513991,24854739,54084539,11309584
"2018","42251323270000",2076397.24,283785.1739,2013-03-01,601090,25455829,54084539,12445227
"2019","42251323270000",2076397.24,283785.1739,2013-04-01,490790,25946619,54084539,11899338
"2020","42251323270000",2076397.24,283785.1739,2013-05-01,506591,26453210,54084539,11963242
"2021","42251323270000",2076397.24,283785.1739,2013-06-01,646364,27099574,54084539,11514151
"2022","42251323270000",2076397.24,283785.1739,2013-07-01,673538,27773112,54084539,12334827
"2023","42251323270000",2076397.24,283785.1739,2013-08-01,627425,28400537,54084539,12036527
"2024","42251323270000",2076397.24,283785.1739,2013-09-01,648658,29049195,54084539,11831621
"2025","42251323270000",2076397.24,283785.1739,2013-10-01,672200,29721395,54084539,11912081
"2026","42251323270000",2076397.24,283785.1739,2013-11-01,677338,30398733,54084539,11402351
"2027","42251323270000",2076397.24,283785.1739,2013-12-01,657947,31056680,54084539,10800800
"2028","42251323270000",2076397.24,283785.1739,2014-01-01,733806,31790486,54084539,11386084
"2029","42251323270000",2076397.24,283785.1739,2014-02-01,330452,32120938,54084539,9936683
"2030","42251323270000",2076397.24,283785.1739,2014-03-01,702746,32823684,54084539,12046987
"2031","42251323270000",2076397.24,283785.1739,2014-04-01,698181,33521865,54084539,11738869
"2032","42251323270000",2076397.24,283785.1739,2014-05-01,746500,34268365,54084539,12165041
"2033","42251323270000",2076397.24,283785.1739,2014-06-01,680360,34948725,54084539,11720072
"2034","42251323270000",2076397.24,283785.1739,2014-07-01,722595,35671320,54084539,11632955
"2035","42251323270000",2076397.24,283785.1739,2014-08-01,549076,36220396,54084539,11280396
"2036","42251323270000",2076397.24,283785.1739,2014-09-01,523259,36743655,54084539,10707843
"2037","42251323270000",2076397.24,283785.1739,2014-10-01,552163,37295818,54084539,11154961
"2038","42251323270000",2076397.24,283785.1739,2014-11-01,557482,37853300,54084539,11006198
"2039","42251323270000",2076397.24,283785.1739,2014-12-01,643624,38496924,54084539,11175048
"2040","42251323270000",2076397.24,283785.1739,2015-01-01,624049,39120973,54084539,11188192
"2041","42251323270000",2076397.24,283785.1739,2015-02-01,585269,39706242,54084539,9285348
"2042","42251323270000",2076397.24,283785.1739,2015-03-01,688484,40394726,54084539,11132951
"2043","42251323270000",2076397.24,283785.1739,2015-04-01,643283,41038009,54084539,10228970
"2044","42251323270000",2076397.24,283785.1739,2015-05-01,567577,41605586,54084539,10731832
"2045","42251323270000",2076397.24,283785.1739,2015-06-01,589245,42194831,54084539,10019178
"2046","42251323270000",2076397.24,283785.1739,2015-07-01,552599,42747430,54084539,9556838
"2047","42251323270000",2076397.24,283785.1739,2015-08-01,540013,43287443,54084539,9046352
"2048","42251323270000",2076397.24,283785.1739,2015-09-01,545846,43833289,54084539,8436833
"2049","42251323270000",2076397.24,283785.1739,2015-10-01,577504,44410793,54084539,8702949
"2050","42251323270000",2076397.24,283785.1739,2015-11-01,577918,44988711,54084539,8702391
"2051","42251323270000",2076397.24,283785.1739,2015-12-01,672341,45661052,54084539,8797617
"2052","42251323270000",2076397.24,283785.1739,2016-01-01,497092,46158144,54084539,8785697
"2053","42251323270000",2076397.24,283785.1739,2016-02-01,347868,46506012,54084539,8098391
"2054","42251323270000",2076397.24,283785.1739,2016-03-01,409808,46915820,54084539,8313445
"2055","42251323270000",2076397.24,283785.1739,2016-04-01,340571,47256391,54084539,8067410
"2056","42251323270000",2076397.24,283785.1739,2016-05-01,342223,47598614,54084539,8687363
"2057","42251323270000",2076397.24,283785.1739,2016-06-01,342226,47940840,54084539,8474598
"2058","42251323270000",2076397.24,283785.1739,2016-07-01,494130,48434970,54084539,8474294
"2059","42251323270000",2076397.24,283785.1739,2016-08-01,518942,48953912,54084539,8424724
"2060","42251323270000",2076397.24,283785.1739,2016-09-01,532530,49486442,54084539,7958587
"2061","42251323270000",2076397.24,283785.1739,2016-10-01,443058,49929500,54084539,7328643
"2062","42251323270000",2076397.24,283785.1739,2016-11-01,433835,50363335,54084539,7108192
"2063","42251323270000",2076397.24,283785.1739,2016-12-01,448552,50811887,54084539,7206177
"2064","42251323270000",2076397.24,283785.1739,2017-01-01,551196,51363083,54084539,8191419
"2065","42251323270000",2076397.24,283785.1739,2017-02-01,390382,51753465,54084539,7284679
"2066","42251323270000",2076397.24,283785.1739,2017-03-01,359977,52113442,54084539,7793859
"2067","42251323270000",2076397.24,283785.1739,2017-04-01,340048,52453490,54084539,7558837
"2068","42251323270000",2076397.24,283785.1739,2017-05-01,320278,52773768,54084539,7868617
"2069","42251323270000",2076397.24,283785.1739,2017-06-01,302825,53076593,54084539,7593200
"2070","42251323270000",2076397.24,283785.1739,2017-07-01,316722,53393315,54084539,8034023
"2071","42251323270000",2076397.24,283785.1739,2017-08-01,349582,53742897,54084539,8259439
"2072","42251323270000",2076397.24,283785.1739,2017-09-01,341642,54084539,54084539,7833970
"2073","42251324020000",2122512.1,310268.8382,2009-01-01,163725,163725,64160850,9714975
"2074","42251324020000",2122512.1,310268.8382,2009-02-01,227997,391722,64160850,9563848
"2075","42251324020000",2122512.1,310268.8382,2009-03-01,316215,707937,64160850,10011008
"2076","42251324020000",2122512.1,310268.8382,2009-04-01,391948,1099885,64160850,8817835
"2077","42251324020000",2122512.1,310268.8382,2009-05-01,326555,1426440,64160850,9222275
"2078","42251324020000",2122512.1,310268.8382,2009-06-01,317839,1744279,64160850,8823798
"2079","42251324020000",2122512.1,310268.8382,2009-07-01,388443,2132722,64160850,9681047
"2080","42251324020000",2122512.1,310268.8382,2009-08-01,419844,2552566,64160850,10148823
"2081","42251324020000",2122512.1,310268.8382,2009-09-01,585809,3138375,64160850,9880092
"2082","42251324020000",2122512.1,310268.8382,2009-10-01,589369,3727744,64160850,10866851
"2083","42251324020000",2122512.1,310268.8382,2009-11-01,561808,4289552,64160850,10107974
"2084","42251324020000",2122512.1,310268.8382,2009-12-01,479197,4768749,64160850,10176315
"2085","42251324020000",2122512.1,310268.8382,2010-01-01,457439,5226188,64160850,10900701
"2086","42251324020000",2122512.1,310268.8382,2010-02-01,395705,5621893,64160850,10320596
"2087","42251324020000",2122512.1,310268.8382,2010-03-01,621478,6243371,64160850,12054256
"2088","42251324020000",2122512.1,310268.8382,2010-04-01,741379,6984750,64160850,11657482
"2089","42251324020000",2122512.1,310268.8382,2010-05-01,760693,7745443,64160850,12361540
"2090","42251324020000",2122512.1,310268.8382,2010-06-01,685409,8430852,64160850,11806317
"2091","42251324020000",2122512.1,310268.8382,2010-07-01,731813,9162665,64160850,13014429
"2092","42251324020000",2122512.1,310268.8382,2010-08-01,637713,9800378,64160850,12894731
"2093","42251324020000",2122512.1,310268.8382,2010-09-01,683366,10483744,64160850,13014299
"2094","42251324020000",2122512.1,310268.8382,2010-10-01,754658,11238402,64160850,11689154
"2095","42251324020000",2122512.1,310268.8382,2010-11-01,725107,11963509,64160850,11954124
"2096","42251324020000",2122512.1,310268.8382,2010-12-01,761449,12724958,64160850,12386935
"2097","42251324020000",2122512.1,310268.8382,2011-01-01,726859,13451817,64160850,12491622
"2098","42251324020000",2122512.1,310268.8382,2011-02-01,568571,14020388,64160850,10744516
"2099","42251324020000",2122512.1,310268.8382,2011-03-01,728536,14748924,64160850,13585658
"2100","42251324020000",2122512.1,310268.8382,2011-04-01,696653,15445577,64160850,13823700
"2101","42251324020000",2122512.1,310268.8382,2011-05-01,774792,16220369,64160850,14893483
"2102","42251324020000",2122512.1,310268.8382,2011-06-01,749885,16970254,64160850,13536023
"2103","42251324020000",2122512.1,310268.8382,2011-07-01,768361,17738615,64160850,14060435
"2104","42251324020000",2122512.1,310268.8382,2011-08-01,762094,18500709,64160850,13865713
"2105","42251324020000",2122512.1,310268.8382,2011-09-01,709049,19209758,64160850,13575950
"2106","42251324020000",2122512.1,310268.8382,2011-10-01,722307,19932065,64160850,14224672
"2107","42251324020000",2122512.1,310268.8382,2011-11-01,757303,20689368,64160850,14289379
"2108","42251324020000",2122512.1,310268.8382,2011-12-01,740726,21430094,64160850,14301497
"2109","42251324020000",2122512.1,310268.8382,2012-01-01,753286,22183380,64160850,14393197
"2110","42251324020000",2122512.1,310268.8382,2012-02-01,657377,22840757,64160850,13261820
"2111","42251324020000",2122512.1,310268.8382,2012-03-01,754314,23595071,64160850,14719295
"2112","42251324020000",2122512.1,310268.8382,2012-04-01,720554,24315625,64160850,13422939
"2113","42251324020000",2122512.1,310268.8382,2012-05-01,811960,25127585,64160850,13619470
"2114","42251324020000",2122512.1,310268.8382,2012-06-01,742827,25870412,64160850,12965656
"2115","42251324020000",2122512.1,310268.8382,2012-07-01,744899,26615311,64160850,13735215
"2116","42251324020000",2122512.1,310268.8382,2012-08-01,748081,27363392,64160850,13116786
"2117","42251324020000",2122512.1,310268.8382,2012-09-01,732216,28095608,64160850,12508392
"2118","42251324020000",2122512.1,310268.8382,2012-10-01,771166,28866774,64160850,12829987
"2119","42251324020000",2122512.1,310268.8382,2012-11-01,643024,29509798,64160850,11811242
"2120","42251324020000",2122512.1,310268.8382,2012-12-01,623973,30133771,64160850,12077125
"2121","42251324020000",2122512.1,310268.8382,2013-01-01,790249,30924020,64160850,12754328
"2122","42251324020000",2122512.1,310268.8382,2013-02-01,643875,31567895,64160850,11309584
"2123","42251324020000",2122512.1,310268.8382,2013-03-01,727822,32295717,64160850,12445227
"2124","42251324020000",2122512.1,310268.8382,2013-04-01,688835,32984552,64160850,11899338
"2125","42251324020000",2122512.1,310268.8382,2013-05-01,789531,33774083,64160850,11963242
"2126","42251324020000",2122512.1,310268.8382,2013-06-01,667164,34441247,64160850,11514151
"2127","42251324020000",2122512.1,310268.8382,2013-07-01,787945,35229192,64160850,12334827
"2128","42251324020000",2122512.1,310268.8382,2013-08-01,740544,35969736,64160850,12036527
"2129","42251324020000",2122512.1,310268.8382,2013-09-01,579187,36548923,64160850,11831621
"2130","42251324020000",2122512.1,310268.8382,2013-10-01,688184,37237107,64160850,11912081
"2131","42251324020000",2122512.1,310268.8382,2013-11-01,618758,37855865,64160850,11402351
"2132","42251324020000",2122512.1,310268.8382,2013-12-01,582803,38438668,64160850,10800800
"2133","42251324020000",2122512.1,310268.8382,2014-01-01,664525,39103193,64160850,11386084
"2134","42251324020000",2122512.1,310268.8382,2014-02-01,627236,39730429,64160850,9936683
"2135","42251324020000",2122512.1,310268.8382,2014-03-01,755795,40486224,64160850,12046987
"2136","42251324020000",2122512.1,310268.8382,2014-04-01,691288,41177512,64160850,11738869
"2137","42251324020000",2122512.1,310268.8382,2014-05-01,672532,41850044,64160850,12165041
"2138","42251324020000",2122512.1,310268.8382,2014-06-01,667701,42517745,64160850,11720072
"2139","42251324020000",2122512.1,310268.8382,2014-07-01,605421,43123166,64160850,11632955
"2140","42251324020000",2122512.1,310268.8382,2014-08-01,619771,43742937,64160850,11280396
"2141","42251324020000",2122512.1,310268.8382,2014-09-01,512875,44255812,64160850,10707843
"2142","42251324020000",2122512.1,310268.8382,2014-10-01,655305,44911117,64160850,11154961
"2143","42251324020000",2122512.1,310268.8382,2014-11-01,659177,45570294,64160850,11006198
"2144","42251324020000",2122512.1,310268.8382,2014-12-01,688312,46258606,64160850,11175048
"2145","42251324020000",2122512.1,310268.8382,2015-01-01,659620,46918226,64160850,11188192
"2146","42251324020000",2122512.1,310268.8382,2015-02-01,557851,47476077,64160850,9285348
"2147","42251324020000",2122512.1,310268.8382,2015-03-01,640878,48116955,64160850,11132951
"2148","42251324020000",2122512.1,310268.8382,2015-04-01,462476,48579431,64160850,10228970
"2149","42251324020000",2122512.1,310268.8382,2015-05-01,637496,49216927,64160850,10731832
"2150","42251324020000",2122512.1,310268.8382,2015-06-01,602932,49819859,64160850,10019178
"2151","42251324020000",2122512.1,310268.8382,2015-07-01,428946,50248805,64160850,9556838
"2152","42251324020000",2122512.1,310268.8382,2015-08-01,309748,50558553,64160850,9046352
"2153","42251324020000",2122512.1,310268.8382,2015-09-01,287952,50846505,64160850,8436833
"2154","42251324020000",2122512.1,310268.8382,2015-10-01,329332,51175837,64160850,8702949
"2155","42251324020000",2122512.1,310268.8382,2015-11-01,516664,51692501,64160850,8702391
"2156","42251324020000",2122512.1,310268.8382,2015-12-01,548519,52241020,64160850,8797617
"2157","42251324020000",2122512.1,310268.8382,2016-01-01,565060,52806080,64160850,8785697
"2158","42251324020000",2122512.1,310268.8382,2016-02-01,311265,53117345,64160850,8098391
"2159","42251324020000",2122512.1,310268.8382,2016-03-01,329806,53447151,64160850,8313445
"2160","42251324020000",2122512.1,310268.8382,2016-04-01,544142,53991293,64160850,8067410
"2161","42251324020000",2122512.1,310268.8382,2016-05-01,566605,54557898,64160850,8687363
"2162","42251324020000",2122512.1,310268.8382,2016-06-01,611562,55169460,64160850,8474598
"2163","42251324020000",2122512.1,310268.8382,2016-07-01,519831,55689291,64160850,8474294
"2164","42251324020000",2122512.1,310268.8382,2016-08-01,462917,56152208,64160850,8424724
"2165","42251324020000",2122512.1,310268.8382,2016-09-01,396121,56548329,64160850,7958587
"2166","42251324020000",2122512.1,310268.8382,2016-10-01,522721,57071050,64160850,7328643
"2167","42251324020000",2122512.1,310268.8382,2016-11-01,661149,57732199,64160850,7108192
"2168","42251324020000",2122512.1,310268.8382,2016-12-01,735797,58467996,64160850,7206177
"2169","42251324020000",2122512.1,310268.8382,2017-01-01,714334,59182330,64160850,8191419
"2170","42251324020000",2122512.1,310268.8382,2017-02-01,608421,59790751,64160850,7284679
"2171","42251324020000",2122512.1,310268.8382,2017-03-01,664393,60455144,64160850,7793859
"2172","42251324020000",2122512.1,310268.8382,2017-04-01,673572,61128716,64160850,7558837
"2173","42251324020000",2122512.1,310268.8382,2017-05-01,701594,61830310,64160850,7868617
"2174","42251324020000",2122512.1,310268.8382,2017-06-01,627018,62457328,64160850,7593200
"2175","42251324020000",2122512.1,310268.8382,2017-07-01,619435,63076763,64160850,8034023
"2176","42251324020000",2122512.1,310268.8382,2017-08-01,604718,63681481,64160850,8259439
"2177","42251324020000",2122512.1,310268.8382,2017-09-01,479369,64160850,64160850,7833970
"2178","42251324500000",2106743.081,275470.9791,2008-08-01,13650,13650,24968218,9977335
"2179","42251324500000",2106743.081,275470.9791,2008-09-01,249438,263088,24968218,9513587
"2180","42251324500000",2106743.081,275470.9791,2008-10-01,353566,616654,24968218,9729575
"2181","42251324500000",2106743.081,275470.9791,2008-11-01,343691,960345,24968218,10178583
"2182","42251324500000",2106743.081,275470.9791,2008-12-01,444125,1404470,24968218,9857864
"2183","42251324500000",2106743.081,275470.9791,2009-01-01,433651,1838121,24968218,9714975
"2184","42251324500000",2106743.081,275470.9791,2009-02-01,349273,2187394,24968218,9563848
"2185","42251324500000",2106743.081,275470.9791,2009-03-01,461044,2648438,24968218,10011008
"2186","42251324500000",2106743.081,275470.9791,2009-04-01,425476,3073914,24968218,8817835
"2187","42251324500000",2106743.081,275470.9791,2009-05-01,456877,3530791,24968218,9222275
"2188","42251324500000",2106743.081,275470.9791,2009-06-01,480749,4011540,24968218,8823798
"2189","42251324500000",2106743.081,275470.9791,2009-07-01,340495,4352035,24968218,9681047
"2190","42251324500000",2106743.081,275470.9791,2009-08-01,301352,4653387,24968218,10148823
"2191","42251324500000",2106743.081,275470.9791,2009-09-01,313849,4967236,24968218,9880092
"2192","42251324500000",2106743.081,275470.9791,2009-10-01,278395,5245631,24968218,10866851
"2193","42251324500000",2106743.081,275470.9791,2009-11-01,262697,5508328,24968218,10107974
"2194","42251324500000",2106743.081,275470.9791,2009-12-01,237087,5745415,24968218,10176315
"2195","42251324500000",2106743.081,275470.9791,2010-01-01,207309,5952724,24968218,10900701
"2196","42251324500000",2106743.081,275470.9791,2010-02-01,118605,6071329,24968218,10320596
"2197","42251324500000",2106743.081,275470.9791,2010-03-01,111370,6182699,24968218,12054256
"2198","42251324500000",2106743.081,275470.9791,2010-04-01,99606,6282305,24968218,11657482
"2199","42251324500000",2106743.081,275470.9791,2010-05-01,159483,6441788,24968218,12361540
"2200","42251324500000",2106743.081,275470.9791,2010-06-01,306054,6747842,24968218,11806317
"2201","42251324500000",2106743.081,275470.9791,2010-07-01,207726,6955568,24968218,13014429
"2202","42251324500000",2106743.081,275470.9791,2010-08-01,224778,7180346,24968218,12894731
"2203","42251324500000",2106743.081,275470.9791,2010-09-01,242508,7422854,24968218,13014299
"2204","42251324500000",2106743.081,275470.9791,2010-10-01,237172,7660026,24968218,11689154
"2205","42251324500000",2106743.081,275470.9791,2010-11-01,322689,7982715,24968218,11954124
"2206","42251324500000",2106743.081,275470.9791,2010-12-01,389965,8372680,24968218,12386935
"2207","42251324500000",2106743.081,275470.9791,2011-01-01,453902,8826582,24968218,12491622
"2208","42251324500000",2106743.081,275470.9791,2011-02-01,307412,9133994,24968218,10744516
"2209","42251324500000",2106743.081,275470.9791,2011-03-01,348260,9482254,24968218,13585658
"2210","42251324500000",2106743.081,275470.9791,2011-04-01,344144,9826398,24968218,13823700
"2211","42251324500000",2106743.081,275470.9791,2011-05-01,433532,10259930,24968218,14893483
"2212","42251324500000",2106743.081,275470.9791,2011-06-01,343008,10602938,24968218,13536023
"2213","42251324500000",2106743.081,275470.9791,2011-07-01,320778,10923716,24968218,14060435
"2214","42251324500000",2106743.081,275470.9791,2011-08-01,256495,11180211,24968218,13865713
"2215","42251324500000",2106743.081,275470.9791,2011-09-01,290729,11470940,24968218,13575950
"2216","42251324500000",2106743.081,275470.9791,2011-10-01,325074,11796014,24968218,14224672
"2217","42251324500000",2106743.081,275470.9791,2011-11-01,304970,12100984,24968218,14289379
"2218","42251324500000",2106743.081,275470.9791,2011-12-01,319762,12420746,24968218,14301497
"2219","42251324500000",2106743.081,275470.9791,2012-01-01,305325,12726071,24968218,14393197
"2220","42251324500000",2106743.081,275470.9791,2012-02-01,303737,13029808,24968218,13261820
"2221","42251324500000",2106743.081,275470.9791,2012-03-01,512356,13542164,24968218,14719295
"2222","42251324500000",2106743.081,275470.9791,2012-04-01,400288,13942452,24968218,13422939
"2223","42251324500000",2106743.081,275470.9791,2012-05-01,313677,14256129,24968218,13619470
"2224","42251324500000",2106743.081,275470.9791,2012-06-01,241847,14497976,24968218,12965656
"2225","42251324500000",2106743.081,275470.9791,2012-07-01,236709,14734685,24968218,13735215
"2226","42251324500000",2106743.081,275470.9791,2012-08-01,223914,14958599,24968218,13116786
"2227","42251324500000",2106743.081,275470.9791,2012-09-01,309434,15268033,24968218,12508392
"2228","42251324500000",2106743.081,275470.9791,2012-10-01,314579,15582612,24968218,12829987
"2229","42251324500000",2106743.081,275470.9791,2012-11-01,293508,15876120,24968218,11811242
"2230","42251324500000",2106743.081,275470.9791,2012-12-01,318882,16195002,24968218,12077125
"2231","42251324500000",2106743.081,275470.9791,2013-01-01,276627,16471629,24968218,12754328
"2232","42251324500000",2106743.081,275470.9791,2013-02-01,249744,16721373,24968218,11309584
"2233","42251324500000",2106743.081,275470.9791,2013-03-01,258104,16979477,24968218,12445227
"2234","42251324500000",2106743.081,275470.9791,2013-04-01,248581,17228058,24968218,11899338
"2235","42251324500000",2106743.081,275470.9791,2013-05-01,211818,17439876,24968218,11963242
"2236","42251324500000",2106743.081,275470.9791,2013-06-01,231428,17671304,24968218,11514151
"2237","42251324500000",2106743.081,275470.9791,2013-07-01,227369,17898673,24968218,12334827
"2238","42251324500000",2106743.081,275470.9791,2013-08-01,205158,18103831,24968218,12036527
"2239","42251324500000",2106743.081,275470.9791,2013-09-01,121987,18225818,24968218,11831621
"2240","42251324500000",2106743.081,275470.9791,2013-10-01,105326,18331144,24968218,11912081
"2241","42251324500000",2106743.081,275470.9791,2013-11-01,60680,18391824,24968218,11402351
"2242","42251324500000",2106743.081,275470.9791,2013-12-01,91530,18483354,24968218,10800800
"2243","42251324500000",2106743.081,275470.9791,2014-01-01,92258,18575612,24968218,11386084
"2244","42251324500000",2106743.081,275470.9791,2014-02-01,113058,18688670,24968218,9936683
"2245","42251324500000",2106743.081,275470.9791,2014-03-01,125636,18814306,24968218,12046987
"2246","42251324500000",2106743.081,275470.9791,2014-04-01,122884,18937190,24968218,11738869
"2247","42251324500000",2106743.081,275470.9791,2014-05-01,141044,19078234,24968218,12165041
"2248","42251324500000",2106743.081,275470.9791,2014-06-01,159258,19237492,24968218,11720072
"2249","42251324500000",2106743.081,275470.9791,2014-07-01,166664,19404156,24968218,11632955
"2250","42251324500000",2106743.081,275470.9791,2014-08-01,197653,19601809,24968218,11280396
"2251","42251324500000",2106743.081,275470.9791,2014-09-01,156288,19758097,24968218,10707843
"2252","42251324500000",2106743.081,275470.9791,2014-10-01,217082,19975179,24968218,11154961
"2253","42251324500000",2106743.081,275470.9791,2014-11-01,143647,20118826,24968218,11006198
"2254","42251324500000",2106743.081,275470.9791,2014-12-01,141217,20260043,24968218,11175048
"2255","42251324500000",2106743.081,275470.9791,2015-01-01,128884,20388927,24968218,11188192
"2256","42251324500000",2106743.081,275470.9791,2015-02-01,91180,20480107,24968218,9285348
"2257","42251324500000",2106743.081,275470.9791,2015-03-01,76551,20556658,24968218,11132951
"2258","42251324500000",2106743.081,275470.9791,2015-04-01,67654,20624312,24968218,10228970
"2259","42251324500000",2106743.081,275470.9791,2015-05-01,56819,20681131,24968218,10731832
"2260","42251324500000",2106743.081,275470.9791,2015-06-01,87290,20768421,24968218,10019178
"2261","42251324500000",2106743.081,275470.9791,2015-07-01,283495,21051916,24968218,9556838
"2262","42251324500000",2106743.081,275470.9791,2015-08-01,197653,21249569,24968218,9046352
"2263","42251324500000",2106743.081,275470.9791,2015-09-01,56809,21306378,24968218,8436833
"2264","42251324500000",2106743.081,275470.9791,2015-10-01,91769,21398147,24968218,8702949
"2265","42251324500000",2106743.081,275470.9791,2015-11-01,90055,21488202,24968218,8702391
"2266","42251324500000",2106743.081,275470.9791,2015-12-01,48117,21536319,24968218,8797617
"2267","42251324500000",2106743.081,275470.9791,2016-01-01,49645,21585964,24968218,8785697
"2268","42251324500000",2106743.081,275470.9791,2016-02-01,52344,21638308,24968218,8098391
"2269","42251324500000",2106743.081,275470.9791,2016-03-01,175000,21813308,24968218,8313445
"2270","42251324500000",2106743.081,275470.9791,2016-04-01,79901,21893209,24968218,8067410
"2271","42251324500000",2106743.081,275470.9791,2016-05-01,172652,22065861,24968218,8687363
"2272","42251324500000",2106743.081,275470.9791,2016-06-01,186002,22251863,24968218,8474598
"2273","42251324500000",2106743.081,275470.9791,2016-07-01,167284,22419147,24968218,8474294
"2274","42251324500000",2106743.081,275470.9791,2016-08-01,259333,22678480,24968218,8424724
"2275","42251324500000",2106743.081,275470.9791,2016-09-01,343913,23022393,24968218,7958587
"2276","42251324500000",2106743.081,275470.9791,2016-10-01,261216,23283609,24968218,7328643
"2277","42251324500000",2106743.081,275470.9791,2016-11-01,166729,23450338,24968218,7108192
"2278","42251324500000",2106743.081,275470.9791,2016-12-01,153207,23603545,24968218,7206177
"2279","42251324500000",2106743.081,275470.9791,2017-01-01,144659,23748204,24968218,8191419
"2280","42251324500000",2106743.081,275470.9791,2017-02-01,130965,23879169,24968218,7284679
"2281","42251324500000",2106743.081,275470.9791,2017-03-01,116173,23995342,24968218,7793859
"2282","42251324500000",2106743.081,275470.9791,2017-04-01,153976,24149318,24968218,7558837
"2283","42251324500000",2106743.081,275470.9791,2017-05-01,173442,24322760,24968218,7868617
"2284","42251324500000",2106743.081,275470.9791,2017-06-01,162652,24485412,24968218,7593200
"2285","42251324500000",2106743.081,275470.9791,2017-07-01,165195,24650607,24968218,8034023
"2286","42251324500000",2106743.081,275470.9791,2017-08-01,174538,24825145,24968218,8259439
"2287","42251324500000",2106743.081,275470.9791,2017-09-01,143073,24968218,24968218,7833970
"2288","42251333350000",2019238.164,308336.627,2009-05-01,29650,29650,38495214,9222275
"2289","42251333350000",2019238.164,308336.627,2009-06-01,271350,301000,38495214,8823798
"2290","42251333350000",2019238.164,308336.627,2009-07-01,271987,572987,38495214,9681047
"2291","42251333350000",2019238.164,308336.627,2009-08-01,308544,881531,38495214,10148823
"2292","42251333350000",2019238.164,308336.627,2009-09-01,351492,1233023,38495214,9880092
"2293","42251333350000",2019238.164,308336.627,2009-10-01,319606,1552629,38495214,10866851
"2294","42251333350000",2019238.164,308336.627,2009-11-01,340610,1893239,38495214,10107974
"2295","42251333350000",2019238.164,308336.627,2009-12-01,362071,2255310,38495214,10176315
"2296","42251333350000",2019238.164,308336.627,2010-01-01,328248,2583558,38495214,10900701
"2297","42251333350000",2019238.164,308336.627,2010-02-01,303998,2887556,38495214,10320596
"2298","42251333350000",2019238.164,308336.627,2010-03-01,410556,3298112,38495214,12054256
"2299","42251333350000",2019238.164,308336.627,2010-04-01,509650,3807762,38495214,11657482
"2300","42251333350000",2019238.164,308336.627,2010-05-01,535352,4343114,38495214,12361540
"2301","42251333350000",2019238.164,308336.627,2010-06-01,372839,4715953,38495214,11806317
"2302","42251333350000",2019238.164,308336.627,2010-07-01,436409,5152362,38495214,13014429
"2303","42251333350000",2019238.164,308336.627,2010-08-01,399323,5551685,38495214,12894731
"2304","42251333350000",2019238.164,308336.627,2010-09-01,493867,6045552,38495214,13014299
"2305","42251333350000",2019238.164,308336.627,2010-10-01,485336,6530888,38495214,11689154
"2306","42251333350000",2019238.164,308336.627,2010-11-01,437024,6967912,38495214,11954124
"2307","42251333350000",2019238.164,308336.627,2010-12-01,520429,7488341,38495214,12386935
"2308","42251333350000",2019238.164,308336.627,2011-01-01,437312,7925653,38495214,12491622
"2309","42251333350000",2019238.164,308336.627,2011-02-01,404588,8330241,38495214,10744516
"2310","42251333350000",2019238.164,308336.627,2011-03-01,492148,8822389,38495214,13585658
"2311","42251333350000",2019238.164,308336.627,2011-04-01,659721,9482110,38495214,13823700
"2312","42251333350000",2019238.164,308336.627,2011-05-01,708061,10190171,38495214,14893483
"2313","42251333350000",2019238.164,308336.627,2011-06-01,629152,10819323,38495214,13536023
"2314","42251333350000",2019238.164,308336.627,2011-07-01,659784,11479107,38495214,14060435
"2315","42251333350000",2019238.164,308336.627,2011-08-01,583957,12063064,38495214,13865713
"2316","42251333350000",2019238.164,308336.627,2011-09-01,623995,12687059,38495214,13575950
"2317","42251333350000",2019238.164,308336.627,2011-10-01,642913,13329972,38495214,14224672
"2318","42251333350000",2019238.164,308336.627,2011-11-01,631688,13961660,38495214,14289379
"2319","42251333350000",2019238.164,308336.627,2011-12-01,565434,14527094,38495214,14301497
"2320","42251333350000",2019238.164,308336.627,2012-01-01,568319,15095413,38495214,14393197
"2321","42251333350000",2019238.164,308336.627,2012-02-01,549281,15644694,38495214,13261820
"2322","42251333350000",2019238.164,308336.627,2012-03-01,634313,16279007,38495214,14719295
"2323","42251333350000",2019238.164,308336.627,2012-04-01,533463,16812470,38495214,13422939
"2324","42251333350000",2019238.164,308336.627,2012-05-01,579686,17392156,38495214,13619470
"2325","42251333350000",2019238.164,308336.627,2012-06-01,507451,17899607,38495214,12965656
"2326","42251333350000",2019238.164,308336.627,2012-07-01,608544,18508151,38495214,13735215
"2327","42251333350000",2019238.164,308336.627,2012-08-01,697517,19205668,38495214,13116786
"2328","42251333350000",2019238.164,308336.627,2012-09-01,619468,19825136,38495214,12508392
"2329","42251333350000",2019238.164,308336.627,2012-10-01,681948,20507084,38495214,12829987
"2330","42251333350000",2019238.164,308336.627,2012-11-01,542765,21049849,38495214,11811242
"2331","42251333350000",2019238.164,308336.627,2012-12-01,586101,21635950,38495214,12077125
"2332","42251333350000",2019238.164,308336.627,2013-01-01,614014,22249964,38495214,12754328
"2333","42251333350000",2019238.164,308336.627,2013-02-01,559301,22809265,38495214,11309584
"2334","42251333350000",2019238.164,308336.627,2013-03-01,654990,23464255,38495214,12445227
"2335","42251333350000",2019238.164,308336.627,2013-04-01,621590,24085845,38495214,11899338
"2336","42251333350000",2019238.164,308336.627,2013-05-01,566978,24652823,38495214,11963242
"2337","42251333350000",2019238.164,308336.627,2013-06-01,345696,24998519,38495214,11514151
"2338","42251333350000",2019238.164,308336.627,2013-07-01,592629,25591148,38495214,12334827
"2339","42251333350000",2019238.164,308336.627,2013-08-01,611499,26202647,38495214,12036527
"2340","42251333350000",2019238.164,308336.627,2013-09-01,617030,26819677,38495214,11831621
"2341","42251333350000",2019238.164,308336.627,2013-10-01,586042,27405719,38495214,11912081
"2342","42251333350000",2019238.164,308336.627,2013-11-01,528869,27934588,38495214,11402351
"2343","42251333350000",2019238.164,308336.627,2013-12-01,386320,28320908,38495214,10800800
"2344","42251333350000",2019238.164,308336.627,2014-01-01,467779,28788687,38495214,11386084
"2345","42251333350000",2019238.164,308336.627,2014-02-01,306434,29095121,38495214,9936683
"2346","42251333350000",2019238.164,308336.627,2014-03-01,404546,29499667,38495214,12046987
"2347","42251333350000",2019238.164,308336.627,2014-04-01,488260,29987927,38495214,11738869
"2348","42251333350000",2019238.164,308336.627,2014-05-01,500455,30488382,38495214,12165041
"2349","42251333350000",2019238.164,308336.627,2014-06-01,429494,30917876,38495214,11720072
"2350","42251333350000",2019238.164,308336.627,2014-07-01,303469,31221345,38495214,11632955
"2351","42251333350000",2019238.164,308336.627,2014-08-01,296879,31518224,38495214,11280396
"2352","42251333350000",2019238.164,308336.627,2014-09-01,290256,31808480,38495214,10707843
"2353","42251333350000",2019238.164,308336.627,2014-10-01,284430,32092910,38495214,11154961
"2354","42251333350000",2019238.164,308336.627,2014-11-01,323004,32415914,38495214,11006198
"2355","42251333350000",2019238.164,308336.627,2014-12-01,263942,32679856,38495214,11175048
"2356","42251333350000",2019238.164,308336.627,2015-01-01,255628,32935484,38495214,11188192
"2357","42251333350000",2019238.164,308336.627,2015-02-01,215027,33150511,38495214,9285348
"2358","42251333350000",2019238.164,308336.627,2015-03-01,221541,33372052,38495214,11132951
"2359","42251333350000",2019238.164,308336.627,2015-04-01,250466,33622518,38495214,10228970
"2360","42251333350000",2019238.164,308336.627,2015-05-01,272123,33894641,38495214,10731832
"2361","42251333350000",2019238.164,308336.627,2015-06-01,276651,34171292,38495214,10019178
"2362","42251333350000",2019238.164,308336.627,2015-07-01,260597,34431889,38495214,9556838
"2363","42251333350000",2019238.164,308336.627,2015-08-01,208550,34640439,38495214,9046352
"2364","42251333350000",2019238.164,308336.627,2015-09-01,228397,34868836,38495214,8436833
"2365","42251333350000",2019238.164,308336.627,2015-10-01,277305,35146141,38495214,8702949
"2366","42251333350000",2019238.164,308336.627,2015-11-01,290200,35436341,38495214,8702391
"2367","42251333350000",2019238.164,308336.627,2015-12-01,317639,35753980,38495214,8797617
"2368","42251333350000",2019238.164,308336.627,2016-01-01,266434,36020414,38495214,8785697
"2369","42251333350000",2019238.164,308336.627,2016-02-01,180878,36201292,38495214,8098391
"2370","42251333350000",2019238.164,308336.627,2016-03-01,176522,36377814,38495214,8313445
"2371","42251333350000",2019238.164,308336.627,2016-04-01,132350,36510164,38495214,8067410
"2372","42251333350000",2019238.164,308336.627,2016-05-01,127828,36637992,38495214,8687363
"2373","42251333350000",2019238.164,308336.627,2016-06-01,144580,36782572,38495214,8474598
"2374","42251333350000",2019238.164,308336.627,2016-07-01,120600,36903172,38495214,8474294
"2375","42251333350000",2019238.164,308336.627,2016-08-01,105766,37008938,38495214,8424724
"2376","42251333350000",2019238.164,308336.627,2016-09-01,228026,37236964,38495214,7958587
"2377","42251333350000",2019238.164,308336.627,2016-10-01,96472,37333436,38495214,7328643
"2378","42251333350000",2019238.164,308336.627,2016-11-01,93370,37426806,38495214,7108192
"2379","42251333350000",2019238.164,308336.627,2016-12-01,177438,37604244,38495214,7206177
"2380","42251333350000",2019238.164,308336.627,2017-01-01,139926,37744170,38495214,8191419
"2381","42251333350000",2019238.164,308336.627,2017-02-01,100968,37845138,38495214,7284679
"2382","42251333350000",2019238.164,308336.627,2017-03-01,104460,37949598,38495214,7793859
"2383","42251333350000",2019238.164,308336.627,2017-04-01,86548,38036146,38495214,7558837
"2384","42251333350000",2019238.164,308336.627,2017-05-01,82114,38118260,38495214,7868617
"2385","42251333350000",2019238.164,308336.627,2017-06-01,83844,38202104,38495214,7593200
"2386","42251333350000",2019238.164,308336.627,2017-07-01,90888,38292992,38495214,8034023
"2387","42251333350000",2019238.164,308336.627,2017-08-01,89538,38382530,38495214,8259439
"2388","42251333350000",2019238.164,308336.627,2017-09-01,112684,38495214,38495214,7833970
"2389","42251341210000",2100283.266,307820.4526,2011-01-01,197232,197232,49534975,12491622
"2390","42251341210000",2100283.266,307820.4526,2011-02-01,302284,499516,49534975,10744516
"2391","42251341210000",2100283.266,307820.4526,2011-03-01,500984,1000500,49534975,13585658
"2392","42251341210000",2100283.266,307820.4526,2011-04-01,463346,1463846,49534975,13823700
"2393","42251341210000",2100283.266,307820.4526,2011-05-01,462639,1926485,49534975,14893483
"2394","42251341210000",2100283.266,307820.4526,2011-06-01,415886,2342371,49534975,13536023
"2395","42251341210000",2100283.266,307820.4526,2011-07-01,368894,2711265,49534975,14060435
"2396","42251341210000",2100283.266,307820.4526,2011-08-01,563097,3274362,49534975,13865713
"2397","42251341210000",2100283.266,307820.4526,2011-09-01,525098,3799460,49534975,13575950
"2398","42251341210000",2100283.266,307820.4526,2011-10-01,738407,4537867,49534975,14224672
"2399","42251341210000",2100283.266,307820.4526,2011-11-01,665133,5203000,49534975,14289379
"2400","42251341210000",2100283.266,307820.4526,2011-12-01,659510,5862510,49534975,14301497
"2401","42251341210000",2100283.266,307820.4526,2012-01-01,665536,6528046,49534975,14393197
"2402","42251341210000",2100283.266,307820.4526,2012-02-01,646373,7174419,49534975,13261820
"2403","42251341210000",2100283.266,307820.4526,2012-03-01,670612,7845031,49534975,14719295
"2404","42251341210000",2100283.266,307820.4526,2012-04-01,663533,8508564,49534975,13422939
"2405","42251341210000",2100283.266,307820.4526,2012-05-01,491961,9000525,49534975,13619470
"2406","42251341210000",2100283.266,307820.4526,2012-06-01,561797,9562322,49534975,12965656
"2407","42251341210000",2100283.266,307820.4526,2012-07-01,640163,10202485,49534975,13735215
"2408","42251341210000",2100283.266,307820.4526,2012-08-01,723620,10926105,49534975,13116786
"2409","42251341210000",2100283.266,307820.4526,2012-09-01,638049,11564154,49534975,12508392
"2410","42251341210000",2100283.266,307820.4526,2012-10-01,743931,12308085,49534975,12829987
"2411","42251341210000",2100283.266,307820.4526,2012-11-01,285033,12593118,49534975,11811242
"2412","42251341210000",2100283.266,307820.4526,2012-12-01,628237,13221355,49534975,12077125
"2413","42251341210000",2100283.266,307820.4526,2013-01-01,832881,14054236,49534975,12754328
"2414","42251341210000",2100283.266,307820.4526,2013-02-01,692092,14746328,49534975,11309584
"2415","42251341210000",2100283.266,307820.4526,2013-03-01,752824,15499152,49534975,12445227
"2416","42251341210000",2100283.266,307820.4526,2013-04-01,720976,16220128,49534975,11899338
"2417","42251341210000",2100283.266,307820.4526,2013-05-01,738415,16958543,49534975,11963242
"2418","42251341210000",2100283.266,307820.4526,2013-06-01,752566,17711109,49534975,11514151
"2419","42251341210000",2100283.266,307820.4526,2013-07-01,787144,18498253,49534975,12334827
"2420","42251341210000",2100283.266,307820.4526,2013-08-01,734947,19233200,49534975,12036527
"2421","42251341210000",2100283.266,307820.4526,2013-09-01,713117,19946317,49534975,11831621
"2422","42251341210000",2100283.266,307820.4526,2013-10-01,795296,20741613,49534975,11912081
"2423","42251341210000",2100283.266,307820.4526,2013-11-01,729067,21470680,49534975,11402351
"2424","42251341210000",2100283.266,307820.4526,2013-12-01,706393,22177073,49534975,10800800
"2425","42251341210000",2100283.266,307820.4526,2014-01-01,866126,23043199,49534975,11386084
"2426","42251341210000",2100283.266,307820.4526,2014-02-01,731354,23774553,49534975,9936683
"2427","42251341210000",2100283.266,307820.4526,2014-03-01,747737,24522290,49534975,12046987
"2428","42251341210000",2100283.266,307820.4526,2014-04-01,675757,25198047,49534975,11738869
"2429","42251341210000",2100283.266,307820.4526,2014-05-01,727037,25925084,49534975,12165041
"2430","42251341210000",2100283.266,307820.4526,2014-06-01,740935,26666019,49534975,11720072
"2431","42251341210000",2100283.266,307820.4526,2014-07-01,800195,27466214,49534975,11632955
"2432","42251341210000",2100283.266,307820.4526,2014-08-01,827092,28293306,49534975,11280396
"2433","42251341210000",2100283.266,307820.4526,2014-09-01,783357,29076663,49534975,10707843
"2434","42251341210000",2100283.266,307820.4526,2014-10-01,744950,29821613,49534975,11154961
"2435","42251341210000",2100283.266,307820.4526,2014-11-01,762037,30583650,49534975,11006198
"2436","42251341210000",2100283.266,307820.4526,2014-12-01,814571,31398221,49534975,11175048
"2437","42251341210000",2100283.266,307820.4526,2015-01-01,815995,32214216,49534975,11188192
"2438","42251341210000",2100283.266,307820.4526,2015-02-01,678011,32892227,49534975,9285348
"2439","42251341210000",2100283.266,307820.4526,2015-03-01,754924,33647151,49534975,11132951
"2440","42251341210000",2100283.266,307820.4526,2015-04-01,723750,34370901,49534975,10228970
"2441","42251341210000",2100283.266,307820.4526,2015-05-01,651017,35021918,49534975,10731832
"2442","42251341210000",2100283.266,307820.4526,2015-06-01,617288,35639206,49534975,10019178
"2443","42251341210000",2100283.266,307820.4526,2015-07-01,693578,36332784,49534975,9556838
"2444","42251341210000",2100283.266,307820.4526,2015-08-01,509918,36842702,49534975,9046352
"2445","42251341210000",2100283.266,307820.4526,2015-09-01,713851,37556553,49534975,8436833
"2446","42251341210000",2100283.266,307820.4526,2015-10-01,760525,38317078,49534975,8702949
"2447","42251341210000",2100283.266,307820.4526,2015-11-01,714461,39031539,49534975,8702391
"2448","42251341210000",2100283.266,307820.4526,2015-12-01,721494,39753033,49534975,8797617
"2449","42251341210000",2100283.266,307820.4526,2016-01-01,516437,40269470,49534975,8785697
"2450","42251341210000",2100283.266,307820.4526,2016-02-01,459800,40729270,49534975,8098391
"2451","42251341210000",2100283.266,307820.4526,2016-03-01,417143,41146413,49534975,8313445
"2452","42251341210000",2100283.266,307820.4526,2016-04-01,564979,41711392,49534975,8067410
"2453","42251341210000",2100283.266,307820.4526,2016-05-01,673371,42384763,49534975,8687363
"2454","42251341210000",2100283.266,307820.4526,2016-06-01,608296,42993059,49534975,8474598
"2455","42251341210000",2100283.266,307820.4526,2016-07-01,555766,43548825,49534975,8474294
"2456","42251341210000",2100283.266,307820.4526,2016-08-01,588417,44137242,49534975,8424724
"2457","42251341210000",2100283.266,307820.4526,2016-09-01,461381,44598623,49534975,7958587
"2458","42251341210000",2100283.266,307820.4526,2016-10-01,335950,44934573,49534975,7328643
"2459","42251341210000",2100283.266,307820.4526,2016-11-01,276324,45210897,49534975,7108192
"2460","42251341210000",2100283.266,307820.4526,2016-12-01,340926,45551823,49534975,7206177
"2461","42251341210000",2100283.266,307820.4526,2017-01-01,321288,45873111,49534975,8191419
"2462","42251341210000",2100283.266,307820.4526,2017-02-01,263712,46136823,49534975,7284679
"2463","42251341210000",2100283.266,307820.4526,2017-03-01,270922,46407745,49534975,7793859
"2464","42251341210000",2100283.266,307820.4526,2017-04-01,254087,46661832,49534975,7558837
"2465","42251341210000",2100283.266,307820.4526,2017-05-01,302178,46964010,49534975,7868617
"2466","42251341210000",2100283.266,307820.4526,2017-06-01,544181,47508191,49534975,7593200
"2467","42251341210000",2100283.266,307820.4526,2017-07-01,613788,48121979,49534975,8034023
"2468","42251341210000",2100283.266,307820.4526,2017-08-01,692879,48814858,49534975,8259439
"2469","42251341210000",2100283.266,307820.4526,2017-09-01,720117,49534975,49534975,7833970
"2470","42367339990000",1940547.105,463852.2993,2007-12-01,59222,59222,33060201,5777613
"2471","42367339990000",1940547.105,463852.2993,2008-01-01,336779,396001,33060201,6452815
"2472","42367339990000",1940547.105,463852.2993,2008-02-01,441776,837777,33060201,7775520
"2473","42367339990000",1940547.105,463852.2993,2008-03-01,605303,1443080,33060201,9152519
"2474","42367339990000",1940547.105,463852.2993,2008-04-01,691738,2134818,33060201,8881211
"2475","42367339990000",1940547.105,463852.2993,2008-05-01,705595,2840413,33060201,9790992
"2476","42367339990000",1940547.105,463852.2993,2008-06-01,740106,3580519,33060201,9489076
"2477","42367339990000",1940547.105,463852.2993,2008-07-01,676499,4257018,33060201,9342850
"2478","42367339990000",1940547.105,463852.2993,2008-08-01,649985,4907003,33060201,9977335
"2479","42367339990000",1940547.105,463852.2993,2008-09-01,598184,5505187,33060201,9513587
"2480","42367339990000",1940547.105,463852.2993,2008-10-01,606971,6112158,33060201,9729575
"2481","42367339990000",1940547.105,463852.2993,2008-11-01,645406,6757564,33060201,10178583
"2482","42367339990000",1940547.105,463852.2993,2008-12-01,630698,7388262,33060201,9857864
"2483","42367339990000",1940547.105,463852.2993,2009-01-01,619053,8007315,33060201,9714975
"2484","42367339990000",1940547.105,463852.2993,2009-02-01,520477,8527792,33060201,9563848
"2485","42367339990000",1940547.105,463852.2993,2009-03-01,585486,9113278,33060201,10011008
"2486","42367339990000",1940547.105,463852.2993,2009-04-01,501212,9614490,33060201,8817835
"2487","42367339990000",1940547.105,463852.2993,2009-05-01,426205,10040695,33060201,9222275
"2488","42367339990000",1940547.105,463852.2993,2009-06-01,337259,10377954,33060201,8823798
"2489","42367339990000",1940547.105,463852.2993,2009-07-01,356295,10734249,33060201,9681047
"2490","42367339990000",1940547.105,463852.2993,2009-08-01,300548,11034797,33060201,10148823
"2491","42367339990000",1940547.105,463852.2993,2009-09-01,237441,11272238,33060201,9880092
"2492","42367339990000",1940547.105,463852.2993,2009-10-01,262977,11535215,33060201,10866851
"2493","42367339990000",1940547.105,463852.2993,2009-11-01,272298,11807513,33060201,10107974
"2494","42367339990000",1940547.105,463852.2993,2009-12-01,293022,12100535,33060201,10176315
"2495","42367339990000",1940547.105,463852.2993,2010-01-01,323032,12423567,33060201,10900701
"2496","42367339990000",1940547.105,463852.2993,2010-02-01,273303,12696870,33060201,10320596
"2497","42367339990000",1940547.105,463852.2993,2010-03-01,319815,13016685,33060201,12054256
"2498","42367339990000",1940547.105,463852.2993,2010-04-01,280605,13297290,33060201,11657482
"2499","42367339990000",1940547.105,463852.2993,2010-05-01,306960,13604250,33060201,12361540
"2500","42367339990000",1940547.105,463852.2993,2010-06-01,367046,13971296,33060201,11806317
"2501","42367339990000",1940547.105,463852.2993,2010-07-01,376338,14347634,33060201,13014429
"2502","42367339990000",1940547.105,463852.2993,2010-08-01,311800,14659434,33060201,12894731
"2503","42367339990000",1940547.105,463852.2993,2010-09-01,267199,14926633,33060201,13014299
"2504","42367339990000",1940547.105,463852.2993,2011-04-01,355944,15282577,33060201,13823700
"2505","42367339990000",1940547.105,463852.2993,2011-05-01,460394,15742971,33060201,14893483
"2506","42367339990000",1940547.105,463852.2993,2011-06-01,395524,16138495,33060201,13536023
"2507","42367339990000",1940547.105,463852.2993,2011-07-01,313044,16451539,33060201,14060435
"2508","42367339990000",1940547.105,463852.2993,2011-08-01,312975,16764514,33060201,13865713
"2509","42367339990000",1940547.105,463852.2993,2011-09-01,274333,17038847,33060201,13575950
"2510","42367339990000",1940547.105,463852.2993,2011-10-01,271696,17310543,33060201,14224672
"2511","42367339990000",1940547.105,463852.2993,2011-11-01,274081,17584624,33060201,14289379
"2512","42367339990000",1940547.105,463852.2993,2011-12-01,288896,17873520,33060201,14301497
"2513","42367339990000",1940547.105,463852.2993,2012-01-01,332391,18205911,33060201,14393197
"2514","42367339990000",1940547.105,463852.2993,2012-02-01,403811,18609722,33060201,13261820
"2515","42367339990000",1940547.105,463852.2993,2012-03-01,396153,19005875,33060201,14719295
"2516","42367339990000",1940547.105,463852.2993,2012-04-01,321159,19327034,33060201,13422939
"2517","42367339990000",1940547.105,463852.2993,2012-05-01,367608,19694642,33060201,13619470
"2518","42367339990000",1940547.105,463852.2993,2012-06-01,306590,20001232,33060201,12965656
"2519","42367339990000",1940547.105,463852.2993,2012-07-01,320348,20321580,33060201,13735215
"2520","42367339990000",1940547.105,463852.2993,2012-08-01,407945,20729525,33060201,13116786
"2521","42367339990000",1940547.105,463852.2993,2012-09-01,290287,21019812,33060201,12508392
"2522","42367339990000",1940547.105,463852.2993,2012-10-01,271839,21291651,33060201,12829987
"2523","42367339990000",1940547.105,463852.2993,2012-11-01,340489,21632140,33060201,11811242
"2524","42367339990000",1940547.105,463852.2993,2012-12-01,393716,22025856,33060201,12077125
"2525","42367339990000",1940547.105,463852.2993,2013-01-01,400581,22426437,33060201,12754328
"2526","42367339990000",1940547.105,463852.2993,2013-02-01,300381,22726818,33060201,11309584
"2527","42367339990000",1940547.105,463852.2993,2013-03-01,344335,23071153,33060201,12445227
"2528","42367339990000",1940547.105,463852.2993,2013-04-01,357569,23428722,33060201,11899338
"2529","42367339990000",1940547.105,463852.2993,2013-05-01,315603,23744325,33060201,11963242
"2530","42367339990000",1940547.105,463852.2993,2013-06-01,380928,24125253,33060201,11514151
"2531","42367339990000",1940547.105,463852.2993,2013-07-01,298178,24423431,33060201,12334827
"2532","42367339990000",1940547.105,463852.2993,2013-08-01,267283,24690714,33060201,12036527
"2533","42367339990000",1940547.105,463852.2993,2013-09-01,220261,24910975,33060201,11831621
"2534","42367339990000",1940547.105,463852.2993,2013-10-01,221087,25132062,33060201,11912081
"2535","42367339990000",1940547.105,463852.2993,2013-11-01,225232,25357294,33060201,11402351
"2536","42367339990000",1940547.105,463852.2993,2013-12-01,220951,25578245,33060201,10800800
"2537","42367339990000",1940547.105,463852.2993,2014-01-01,291288,25869533,33060201,11386084
"2538","42367339990000",1940547.105,463852.2993,2014-02-01,238650,26108183,33060201,9936683
"2539","42367339990000",1940547.105,463852.2993,2014-03-01,238150,26346333,33060201,12046987
"2540","42367339990000",1940547.105,463852.2993,2014-04-01,194016,26540349,33060201,11738869
"2541","42367339990000",1940547.105,463852.2993,2014-05-01,206212,26746561,33060201,12165041
"2542","42367339990000",1940547.105,463852.2993,2014-06-01,225115,26971676,33060201,11720072
"2543","42367339990000",1940547.105,463852.2993,2014-07-01,194108,27165784,33060201,11632955
"2544","42367339990000",1940547.105,463852.2993,2014-08-01,216193,27381977,33060201,11280396
"2545","42367339990000",1940547.105,463852.2993,2014-09-01,222041,27604018,33060201,10707843
"2546","42367339990000",1940547.105,463852.2993,2014-10-01,212894,27816912,33060201,11154961
"2547","42367339990000",1940547.105,463852.2993,2014-11-01,219383,28036295,33060201,11006198
"2548","42367339990000",1940547.105,463852.2993,2014-12-01,171529,28207824,33060201,11175048
"2549","42367339990000",1940547.105,463852.2993,2015-01-01,203705,28411529,33060201,11188192
"2550","42367339990000",1940547.105,463852.2993,2015-02-01,142298,28553827,33060201,9285348
"2551","42367339990000",1940547.105,463852.2993,2015-03-01,176610,28730437,33060201,11132951
"2552","42367339990000",1940547.105,463852.2993,2015-04-01,165951,28896388,33060201,10228970
"2553","42367339990000",1940547.105,463852.2993,2015-05-01,171043,29067431,33060201,10731832
"2554","42367339990000",1940547.105,463852.2993,2015-06-01,159247,29226678,33060201,10019178
"2555","42367339990000",1940547.105,463852.2993,2015-07-01,156355,29383033,33060201,9556838
"2556","42367339990000",1940547.105,463852.2993,2015-08-01,157502,29540535,33060201,9046352
"2557","42367339990000",1940547.105,463852.2993,2015-09-01,148889,29689424,33060201,8436833
"2558","42367339990000",1940547.105,463852.2993,2015-10-01,162168,29851592,33060201,8702949
"2559","42367339990000",1940547.105,463852.2993,2015-11-01,157873,30009465,33060201,8702391
"2560","42367339990000",1940547.105,463852.2993,2015-12-01,159901,30169366,33060201,8797617
"2561","42367339990000",1940547.105,463852.2993,2016-01-01,160976,30330342,33060201,8785697
"2562","42367339990000",1940547.105,463852.2993,2016-02-01,147005,30477347,33060201,8098391
"2563","42367339990000",1940547.105,463852.2993,2016-03-01,155460,30632807,33060201,8313445
"2564","42367339990000",1940547.105,463852.2993,2016-04-01,138566,30771373,33060201,8067410
"2565","42367339990000",1940547.105,463852.2993,2016-05-01,132221,30903594,33060201,8687363
"2566","42367339990000",1940547.105,463852.2993,2016-06-01,140762,31044356,33060201,8474598
"2567","42367339990000",1940547.105,463852.2993,2016-07-01,141566,31185922,33060201,8474294
"2568","42367339990000",1940547.105,463852.2993,2016-08-01,144849,31330771,33060201,8424724
"2569","42367339990000",1940547.105,463852.2993,2016-09-01,124240,31455011,33060201,7958587
"2570","42367339990000",1940547.105,463852.2993,2016-10-01,116365,31571376,33060201,7328643
"2571","42367339990000",1940547.105,463852.2993,2016-11-01,125291,31696667,33060201,7108192
"2572","42367339990000",1940547.105,463852.2993,2016-12-01,128453,31825120,33060201,7206177
"2573","42367339990000",1940547.105,463852.2993,2017-01-01,124431,31949551,33060201,8191419
"2574","42367339990000",1940547.105,463852.2993,2017-02-01,118033,32067584,33060201,7284679
"2575","42367339990000",1940547.105,463852.2993,2017-03-01,100526,32168110,33060201,7793859
"2576","42367339990000",1940547.105,463852.2993,2017-04-01,90525,32258635,33060201,7558837
"2577","42367339990000",1940547.105,463852.2993,2017-05-01,145196,32403831,33060201,7868617
"2578","42367339990000",1940547.105,463852.2993,2017-06-01,147815,32551646,33060201,7593200
"2579","42367339990000",1940547.105,463852.2993,2017-07-01,176830,32728476,33060201,8034023
"2580","42367339990000",1940547.105,463852.2993,2017-08-01,166456,32894932,33060201,8259439
"2581","42367339990000",1940547.105,463852.2993,2017-09-01,165269,33060201,33060201,7833970
"2582","42367344300000",1965697.102,386411.102,2007-10-01,193836,193836,41917540,6483309
"2583","42367344300000",1965697.102,386411.102,2007-11-01,171931,365767,41917540,6157035
"2584","42367344300000",1965697.102,386411.102,2007-12-01,301084,666851,41917540,5777613
"2585","42367344300000",1965697.102,386411.102,2008-01-01,255520,922371,41917540,6452815
"2586","42367344300000",1965697.102,386411.102,2008-02-01,242376,1164747,41917540,7775520
"2587","42367344300000",1965697.102,386411.102,2008-03-01,157272,1322019,41917540,9152519
"2588","42367344300000",1965697.102,386411.102,2008-04-01,242876,1564895,41917540,8881211
"2589","42367344300000",1965697.102,386411.102,2008-05-01,244610,1809505,41917540,9790992
"2590","42367344300000",1965697.102,386411.102,2008-06-01,190431,1999936,41917540,9489076
"2591","42367344300000",1965697.102,386411.102,2008-07-01,187762,2187698,41917540,9342850
"2592","42367344300000",1965697.102,386411.102,2008-08-01,198641,2386339,41917540,9977335
"2593","42367344300000",1965697.102,386411.102,2008-09-01,167196,2553535,41917540,9513587
"2594","42367344300000",1965697.102,386411.102,2008-10-01,188358,2741893,41917540,9729575
"2595","42367344300000",1965697.102,386411.102,2008-11-01,89287,2831180,41917540,10178583
"2596","42367344300000",1965697.102,386411.102,2008-12-01,133481,2964661,41917540,9857864
"2597","42367344300000",1965697.102,386411.102,2009-01-01,177270,3141931,41917540,9714975
"2598","42367344300000",1965697.102,386411.102,2009-02-01,205162,3347093,41917540,9563848
"2599","42367344300000",1965697.102,386411.102,2009-03-01,293487,3640580,41917540,10011008
"2600","42367344300000",1965697.102,386411.102,2009-04-01,308511,3949091,41917540,8817835
"2601","42367344300000",1965697.102,386411.102,2009-05-01,173885,4122976,41917540,9222275
"2602","42367344300000",1965697.102,386411.102,2009-06-01,182125,4305101,41917540,8823798
"2603","42367344300000",1965697.102,386411.102,2009-07-01,282065,4587166,41917540,9681047
"2604","42367344300000",1965697.102,386411.102,2009-08-01,272084,4859250,41917540,10148823
"2605","42367344300000",1965697.102,386411.102,2009-09-01,318616,5177866,41917540,9880092
"2606","42367344300000",1965697.102,386411.102,2009-10-01,298753,5476619,41917540,10866851
"2607","42367344300000",1965697.102,386411.102,2009-11-01,256091,5732710,41917540,10107974
"2608","42367344300000",1965697.102,386411.102,2009-12-01,25796,5758506,41917540,10176315
"2609","42367344300000",1965697.102,386411.102,2010-01-01,309014,6067520,41917540,10900701
"2610","42367344300000",1965697.102,386411.102,2010-02-01,316291,6383811,41917540,10320596
"2611","42367344300000",1965697.102,386411.102,2010-03-01,405751,6789562,41917540,12054256
"2612","42367344300000",1965697.102,386411.102,2010-04-01,402112,7191674,41917540,11657482
"2613","42367344300000",1965697.102,386411.102,2010-05-01,509389,7701063,41917540,12361540
"2614","42367344300000",1965697.102,386411.102,2010-06-01,269996,7971059,41917540,11806317
"2615","42367344300000",1965697.102,386411.102,2010-07-01,415870,8386929,41917540,13014429
"2616","42367344300000",1965697.102,386411.102,2010-08-01,474482,8861411,41917540,12894731
"2617","42367344300000",1965697.102,386411.102,2010-09-01,552369,9413780,41917540,13014299
"2618","42367344300000",1965697.102,386411.102,2010-10-01,502392,9916172,41917540,11689154
"2619","42367344300000",1965697.102,386411.102,2010-11-01,427112,10343284,41917540,11954124
"2620","42367344300000",1965697.102,386411.102,2010-12-01,396058,10739342,41917540,12386935
"2621","42367344300000",1965697.102,386411.102,2011-01-01,499223,11238565,41917540,12491622
"2622","42367344300000",1965697.102,386411.102,2011-02-01,329213,11567778,41917540,10744516
"2623","42367344300000",1965697.102,386411.102,2011-03-01,320537,11888315,41917540,13585658
"2624","42367344300000",1965697.102,386411.102,2011-04-01,454583,12342898,41917540,13823700
"2625","42367344300000",1965697.102,386411.102,2011-05-01,443882,12786780,41917540,14893483
"2626","42367344300000",1965697.102,386411.102,2011-06-01,472266,13259046,41917540,13536023
"2627","42367344300000",1965697.102,386411.102,2011-07-01,613779,13872825,41917540,14060435
"2628","42367344300000",1965697.102,386411.102,2011-08-01,534067,14406892,41917540,13865713
"2629","42367344300000",1965697.102,386411.102,2011-09-01,558830,14965722,41917540,13575950
"2630","42367344300000",1965697.102,386411.102,2011-10-01,545390,15511112,41917540,14224672
"2631","42367344300000",1965697.102,386411.102,2011-11-01,429790,15940902,41917540,14289379
"2632","42367344300000",1965697.102,386411.102,2011-12-01,459835,16400737,41917540,14301497
"2633","42367344300000",1965697.102,386411.102,2012-01-01,424151,16824888,41917540,14393197
"2634","42367344300000",1965697.102,386411.102,2012-02-01,398923,17223811,41917540,13261820
"2635","42367344300000",1965697.102,386411.102,2012-03-01,511836,17735647,41917540,14719295
"2636","42367344300000",1965697.102,386411.102,2012-04-01,419363,18155010,41917540,13422939
"2637","42367344300000",1965697.102,386411.102,2012-05-01,389547,18544557,41917540,13619470
"2638","42367344300000",1965697.102,386411.102,2012-06-01,514843,19059400,41917540,12965656
"2639","42367344300000",1965697.102,386411.102,2012-07-01,554583,19613983,41917540,13735215
"2640","42367344300000",1965697.102,386411.102,2012-08-01,523441,20137424,41917540,13116786
"2641","42367344300000",1965697.102,386411.102,2012-09-01,502682,20640106,41917540,12508392
"2642","42367344300000",1965697.102,386411.102,2012-10-01,471602,21111708,41917540,12829987
"2643","42367344300000",1965697.102,386411.102,2012-11-01,424532,21536240,41917540,11811242
"2644","42367344300000",1965697.102,386411.102,2012-12-01,412055,21948295,41917540,12077125
"2645","42367344300000",1965697.102,386411.102,2013-01-01,474607,22422902,41917540,12754328
"2646","42367344300000",1965697.102,386411.102,2013-02-01,256679,22679581,41917540,11309584
"2647","42367344300000",1965697.102,386411.102,2013-03-01,293677,22973258,41917540,12445227
"2648","42367344300000",1965697.102,386411.102,2013-04-01,259260,23232518,41917540,11899338
"2649","42367344300000",1965697.102,386411.102,2013-05-01,226477,23458995,41917540,11963242
"2650","42367344300000",1965697.102,386411.102,2013-06-01,207387,23666382,41917540,11514151
"2651","42367344300000",1965697.102,386411.102,2013-07-01,200994,23867376,41917540,12334827
"2652","42367344300000",1965697.102,386411.102,2013-08-01,460378,24327754,41917540,12036527
"2653","42367344300000",1965697.102,386411.102,2013-09-01,441276,24769030,41917540,11831621
"2654","42367344300000",1965697.102,386411.102,2013-10-01,489335,25258365,41917540,11912081
"2655","42367344300000",1965697.102,386411.102,2013-11-01,494867,25753232,41917540,11402351
"2656","42367344300000",1965697.102,386411.102,2013-12-01,453109,26206341,41917540,10800800
"2657","42367344300000",1965697.102,386411.102,2014-01-01,526375,26732716,41917540,11386084
"2658","42367344300000",1965697.102,386411.102,2014-02-01,480304,27213020,41917540,9936683
"2659","42367344300000",1965697.102,386411.102,2014-03-01,470628,27683648,41917540,12046987
"2660","42367344300000",1965697.102,386411.102,2014-04-01,485323,28168971,41917540,11738869
"2661","42367344300000",1965697.102,386411.102,2014-05-01,473641,28642612,41917540,12165041
"2662","42367344300000",1965697.102,386411.102,2014-06-01,440515,29083127,41917540,11720072
"2663","42367344300000",1965697.102,386411.102,2014-07-01,449251,29532378,41917540,11632955
"2664","42367344300000",1965697.102,386411.102,2014-08-01,453211,29985589,41917540,11280396
"2665","42367344300000",1965697.102,386411.102,2014-09-01,475234,30460823,41917540,10707843
"2666","42367344300000",1965697.102,386411.102,2014-10-01,457898,30918721,41917540,11154961
"2667","42367344300000",1965697.102,386411.102,2014-11-01,276813,31195534,41917540,11006198
"2668","42367344300000",1965697.102,386411.102,2014-12-01,501817,31697351,41917540,11175048
"2669","42367344300000",1965697.102,386411.102,2015-01-01,517774,32215125,41917540,11188192
"2670","42367344300000",1965697.102,386411.102,2015-02-01,406450,32621575,41917540,9285348
"2671","42367344300000",1965697.102,386411.102,2015-03-01,469681,33091256,41917540,11132951
"2672","42367344300000",1965697.102,386411.102,2015-04-01,392053,33483309,41917540,10228970
"2673","42367344300000",1965697.102,386411.102,2015-05-01,412126,33895435,41917540,10731832
"2674","42367344300000",1965697.102,386411.102,2015-06-01,458197,34353632,41917540,10019178
"2675","42367344300000",1965697.102,386411.102,2015-07-01,418910,34772542,41917540,9556838
"2676","42367344300000",1965697.102,386411.102,2015-08-01,415259,35187801,41917540,9046352
"2677","42367344300000",1965697.102,386411.102,2015-09-01,371463,35559264,41917540,8436833
"2678","42367344300000",1965697.102,386411.102,2015-10-01,298192,35857456,41917540,8702949
"2679","42367344300000",1965697.102,386411.102,2015-11-01,301052,36158508,41917540,8702391
"2680","42367344300000",1965697.102,386411.102,2015-12-01,288997,36447505,41917540,8797617
"2681","42367344300000",1965697.102,386411.102,2016-01-01,350271,36797776,41917540,8785697
"2682","42367344300000",1965697.102,386411.102,2016-02-01,332535,37130311,41917540,8098391
"2683","42367344300000",1965697.102,386411.102,2016-03-01,335132,37465443,41917540,8313445
"2684","42367344300000",1965697.102,386411.102,2016-04-01,252065,37717508,41917540,8067410
"2685","42367344300000",1965697.102,386411.102,2016-05-01,371165,38088673,41917540,8687363
"2686","42367344300000",1965697.102,386411.102,2016-06-01,132711,38221384,41917540,8474598
"2687","42367344300000",1965697.102,386411.102,2016-07-01,215673,38437057,41917540,8474294
"2688","42367344300000",1965697.102,386411.102,2016-08-01,294094,38731151,41917540,8424724
"2689","42367344300000",1965697.102,386411.102,2016-09-01,249683,38980834,41917540,7958587
"2690","42367344300000",1965697.102,386411.102,2017-01-01,331102,39311936,41917540,8191419
"2691","42367344300000",1965697.102,386411.102,2017-02-01,272662,39584598,41917540,7284679
"2692","42367344300000",1965697.102,386411.102,2017-03-01,405350,39989948,41917540,7793859
"2693","42367344300000",1965697.102,386411.102,2017-04-01,392272,40382220,41917540,7558837
"2694","42367344300000",1965697.102,386411.102,2017-05-01,393445,40775665,41917540,7868617
"2695","42367344300000",1965697.102,386411.102,2017-06-01,349904,41125569,41917540,7593200
"2696","42367344300000",1965697.102,386411.102,2017-07-01,296216,41421785,41917540,8034023
"2697","42367344300000",1965697.102,386411.102,2017-08-01,294094,41715879,41917540,8259439
"2698","42367344300000",1965697.102,386411.102,2017-09-01,201661,41917540,41917540,7833970
"2699","42367344670000",1944463.571,334549.5468,2008-02-01,170562,170562,53442976,7775520
"2700","42367344670000",1944463.571,334549.5468,2008-03-01,296250,466812,53442976,9152519
"2701","42367344670000",1944463.571,334549.5468,2008-04-01,304878,771690,53442976,8881211
"2702","42367344670000",1944463.571,334549.5468,2008-05-01,342778,1114468,53442976,9790992
"2703","42367344670000",1944463.571,334549.5468,2008-06-01,356150,1470618,53442976,9489076
"2704","42367344670000",1944463.571,334549.5468,2008-07-01,466343,1936961,53442976,9342850
"2705","42367344670000",1944463.571,334549.5468,2008-08-01,596732,2533693,53442976,9977335
"2706","42367344670000",1944463.571,334549.5468,2008-09-01,604021,3137714,53442976,9513587
"2707","42367344670000",1944463.571,334549.5468,2008-10-01,528372,3666086,53442976,9729575
"2708","42367344670000",1944463.571,334549.5468,2008-11-01,517732,4183818,53442976,10178583
"2709","42367344670000",1944463.571,334549.5468,2008-12-01,524800,4708618,53442976,9857864
"2710","42367344670000",1944463.571,334549.5468,2009-01-01,510486,5219104,53442976,9714975
"2711","42367344670000",1944463.571,334549.5468,2009-02-01,499247,5718351,53442976,9563848
"2712","42367344670000",1944463.571,334549.5468,2009-03-01,579333,6297684,53442976,10011008
"2713","42367344670000",1944463.571,334549.5468,2009-04-01,476853,6774537,53442976,8817835
"2714","42367344670000",1944463.571,334549.5468,2009-05-01,474354,7248891,53442976,9222275
"2715","42367344670000",1944463.571,334549.5468,2009-06-01,448626,7697517,53442976,8823798
"2716","42367344670000",1944463.571,334549.5468,2009-07-01,455015,8152532,53442976,9681047
"2717","42367344670000",1944463.571,334549.5468,2009-08-01,447747,8600279,53442976,10148823
"2718","42367344670000",1944463.571,334549.5468,2009-09-01,461394,9061673,53442976,9880092
"2719","42367344670000",1944463.571,334549.5468,2009-10-01,527167,9588840,53442976,10866851
"2720","42367344670000",1944463.571,334549.5468,2009-11-01,461930,10050770,53442976,10107974
"2721","42367344670000",1944463.571,334549.5468,2009-12-01,392897,10443667,53442976,10176315
"2722","42367344670000",1944463.571,334549.5468,2010-01-01,390133,10833800,53442976,10900701
"2723","42367344670000",1944463.571,334549.5468,2010-02-01,334290,11168090,53442976,10320596
"2724","42367344670000",1944463.571,334549.5468,2010-03-01,520055,11688145,53442976,12054256
"2725","42367344670000",1944463.571,334549.5468,2010-04-01,528462,12216607,53442976,11657482
"2726","42367344670000",1944463.571,334549.5468,2010-05-01,457701,12674308,53442976,12361540
"2727","42367344670000",1944463.571,334549.5468,2010-06-01,417643,13091951,53442976,11806317
"2728","42367344670000",1944463.571,334549.5468,2010-07-01,462313,13554264,53442976,13014429
"2729","42367344670000",1944463.571,334549.5468,2010-08-01,464576,14018840,53442976,12894731
"2730","42367344670000",1944463.571,334549.5468,2010-09-01,465806,14484646,53442976,13014299
"2731","42367344670000",1944463.571,334549.5468,2010-10-01,463788,14948434,53442976,11689154
"2732","42367344670000",1944463.571,334549.5468,2010-11-01,415747,15364181,53442976,11954124
"2733","42367344670000",1944463.571,334549.5468,2010-12-01,422838,15787019,53442976,12386935
"2734","42367344670000",1944463.571,334549.5468,2011-01-01,414240,16201259,53442976,12491622
"2735","42367344670000",1944463.571,334549.5468,2011-02-01,304699,16505958,53442976,10744516
"2736","42367344670000",1944463.571,334549.5468,2011-03-01,354278,16860236,53442976,13585658
"2737","42367344670000",1944463.571,334549.5468,2011-04-01,472208,17332444,53442976,13823700
"2738","42367344670000",1944463.571,334549.5468,2011-05-01,550435,17882879,53442976,14893483
"2739","42367344670000",1944463.571,334549.5468,2011-06-01,334307,18217186,53442976,13536023
"2740","42367344670000",1944463.571,334549.5468,2011-07-01,349967,18567153,53442976,14060435
"2741","42367344670000",1944463.571,334549.5468,2011-08-01,370502,18937655,53442976,13865713
"2742","42367344670000",1944463.571,334549.5468,2011-09-01,333774,19271429,53442976,13575950
"2743","42367344670000",1944463.571,334549.5468,2011-10-01,388147,19659576,53442976,14224672
"2744","42367344670000",1944463.571,334549.5468,2011-11-01,515995,20175571,53442976,14289379
"2745","42367344670000",1944463.571,334549.5468,2011-12-01,603626,20779197,53442976,14301497
"2746","42367344670000",1944463.571,334549.5468,2012-01-01,578762,21357959,53442976,14393197
"2747","42367344670000",1944463.571,334549.5468,2012-02-01,520803,21878762,53442976,13261820
"2748","42367344670000",1944463.571,334549.5468,2012-03-01,593447,22472209,53442976,14719295
"2749","42367344670000",1944463.571,334549.5468,2012-04-01,468652,22940861,53442976,13422939
"2750","42367344670000",1944463.571,334549.5468,2012-05-01,537352,23478213,53442976,13619470
"2751","42367344670000",1944463.571,334549.5468,2012-06-01,670968,24149181,53442976,12965656
"2752","42367344670000",1944463.571,334549.5468,2012-07-01,696729,24845910,53442976,13735215
"2753","42367344670000",1944463.571,334549.5468,2012-08-01,581601,25427511,53442976,13116786
"2754","42367344670000",1944463.571,334549.5468,2012-09-01,659700,26087211,53442976,12508392
"2755","42367344670000",1944463.571,334549.5468,2012-10-01,603856,26691067,53442976,12829987
"2756","42367344670000",1944463.571,334549.5468,2012-11-01,601208,27292275,53442976,11811242
"2757","42367344670000",1944463.571,334549.5468,2012-12-01,540382,27832657,53442976,12077125
"2758","42367344670000",1944463.571,334549.5468,2013-01-01,713347,28546004,53442976,12754328
"2759","42367344670000",1944463.571,334549.5468,2013-02-01,621048,29167052,53442976,11309584
"2760","42367344670000",1944463.571,334549.5468,2013-03-01,727903,29894955,53442976,12445227
"2761","42367344670000",1944463.571,334549.5468,2013-04-01,773589,30668544,53442976,11899338
"2762","42367344670000",1944463.571,334549.5468,2013-05-01,655372,31323916,53442976,11963242
"2763","42367344670000",1944463.571,334549.5468,2013-06-01,706148,32030064,53442976,11514151
"2764","42367344670000",1944463.571,334549.5468,2013-07-01,636048,32666112,53442976,12334827
"2765","42367344670000",1944463.571,334549.5468,2013-08-01,740982,33407094,53442976,12036527
"2766","42367344670000",1944463.571,334549.5468,2013-09-01,651719,34058813,53442976,11831621
"2767","42367344670000",1944463.571,334549.5468,2013-10-01,512330,34571143,53442976,11912081
"2768","42367344670000",1944463.571,334549.5468,2013-11-01,607764,35178907,53442976,11402351
"2769","42367344670000",1944463.571,334549.5468,2013-12-01,586328,35765235,53442976,10800800
"2770","42367344670000",1944463.571,334549.5468,2014-01-01,643772,36409007,53442976,11386084
"2771","42367344670000",1944463.571,334549.5468,2014-02-01,555554,36964561,53442976,9936683
"2772","42367344670000",1944463.571,334549.5468,2014-03-01,522641,37487202,53442976,12046987
"2773","42367344670000",1944463.571,334549.5468,2014-04-01,489542,37976744,53442976,11738869
"2774","42367344670000",1944463.571,334549.5468,2014-05-01,479237,38455981,53442976,12165041
"2775","42367344670000",1944463.571,334549.5468,2014-06-01,573189,39029170,53442976,11720072
"2776","42367344670000",1944463.571,334549.5468,2014-07-01,501752,39530922,53442976,11632955
"2777","42367344670000",1944463.571,334549.5468,2014-08-01,484154,40015076,53442976,11280396
"2778","42367344670000",1944463.571,334549.5468,2014-09-01,445364,40460440,53442976,10707843
"2779","42367344670000",1944463.571,334549.5468,2014-10-01,462425,40922865,53442976,11154961
"2780","42367344670000",1944463.571,334549.5468,2014-11-01,438182,41361047,53442976,11006198
"2781","42367344670000",1944463.571,334549.5468,2014-12-01,424456,41785503,53442976,11175048
"2782","42367344670000",1944463.571,334549.5468,2015-01-01,458044,42243547,53442976,11188192
"2783","42367344670000",1944463.571,334549.5468,2015-02-01,428718,42672265,53442976,9285348
"2784","42367344670000",1944463.571,334549.5468,2015-03-01,421438,43093703,53442976,11132951
"2785","42367344670000",1944463.571,334549.5468,2015-04-01,374884,43468587,53442976,10228970
"2786","42367344670000",1944463.571,334549.5468,2015-05-01,375072,43843659,53442976,10731832
"2787","42367344670000",1944463.571,334549.5468,2015-06-01,395768,44239427,53442976,10019178
"2788","42367344670000",1944463.571,334549.5468,2015-07-01,443784,44683211,53442976,9556838
"2789","42367344670000",1944463.571,334549.5468,2015-08-01,416808,45100019,53442976,9046352
"2790","42367344670000",1944463.571,334549.5468,2015-09-01,163604,45263623,53442976,8436833
"2791","42367344670000",1944463.571,334549.5468,2015-10-01,441388,45705011,53442976,8702949
"2792","42367344670000",1944463.571,334549.5468,2015-11-01,496122,46201133,53442976,8702391
"2793","42367344670000",1944463.571,334549.5468,2015-12-01,481129,46682262,53442976,8797617
"2794","42367344670000",1944463.571,334549.5468,2016-01-01,439807,47122069,53442976,8785697
"2795","42367344670000",1944463.571,334549.5468,2016-02-01,398200,47520269,53442976,8098391
"2796","42367344670000",1944463.571,334549.5468,2016-03-01,376897,47897166,53442976,8313445
"2797","42367344670000",1944463.571,334549.5468,2016-04-01,385454,48282620,53442976,8067410
"2798","42367344670000",1944463.571,334549.5468,2016-05-01,314511,48597131,53442976,8687363
"2799","42367344670000",1944463.571,334549.5468,2016-06-01,363219,48960350,53442976,8474598
"2800","42367344670000",1944463.571,334549.5468,2016-07-01,380393,49340743,53442976,8474294
"2801","42367344670000",1944463.571,334549.5468,2016-08-01,350307,49691050,53442976,8424724
"2802","42367344670000",1944463.571,334549.5468,2016-09-01,335556,50026606,53442976,7958587
"2803","42367344670000",1944463.571,334549.5468,2016-10-01,320394,50347000,53442976,7328643
"2804","42367344670000",1944463.571,334549.5468,2016-11-01,280119,50627119,53442976,7108192
"2805","42367344670000",1944463.571,334549.5468,2016-12-01,312584,50939703,53442976,7206177
"2806","42367344670000",1944463.571,334549.5468,2017-01-01,422602,51362305,53442976,8191419
"2807","42367344670000",1944463.571,334549.5468,2017-02-01,311003,51673308,53442976,7284679
"2808","42367344670000",1944463.571,334549.5468,2017-03-01,327074,52000382,53442976,7793859
"2809","42367344670000",1944463.571,334549.5468,2017-04-01,296179,52296561,53442976,7558837
"2810","42367344670000",1944463.571,334549.5468,2017-05-01,275009,52571570,53442976,7868617
"2811","42367344670000",1944463.571,334549.5468,2017-06-01,241713,52813283,53442976,7593200
"2812","42367344670000",1944463.571,334549.5468,2017-07-01,219864,53033147,53442976,8034023
"2813","42367344670000",1944463.571,334549.5468,2017-08-01,216151,53249298,53442976,8259439
"2814","42367344670000",1944463.571,334549.5468,2017-09-01,193678,53442976,53442976,7833970
"2815","42367346930000",1976710.027,477029.9949,2009-06-01,152091,152091,29395265,8823798
"2816","42367346930000",1976710.027,477029.9949,2009-07-01,364397,516488,29395265,9681047
"2817","42367346930000",1976710.027,477029.9949,2009-08-01,488277,1004765,29395265,10148823
"2818","42367346930000",1976710.027,477029.9949,2009-09-01,509313,1514078,29395265,9880092
"2819","42367346930000",1976710.027,477029.9949,2009-10-01,429835,1943913,29395265,10866851
"2820","42367346930000",1976710.027,477029.9949,2009-11-01,463259,2407172,29395265,10107974
"2821","42367346930000",1976710.027,477029.9949,2009-12-01,478419,2885591,29395265,10176315
"2822","42367346930000",1976710.027,477029.9949,2010-01-01,424072,3309663,29395265,10900701
"2823","42367346930000",1976710.027,477029.9949,2010-02-01,373112,3682775,29395265,10320596
"2824","42367346930000",1976710.027,477029.9949,2010-03-01,419146,4101921,29395265,12054256
"2825","42367346930000",1976710.027,477029.9949,2010-04-01,392735,4494656,29395265,11657482
"2826","42367346930000",1976710.027,477029.9949,2010-05-01,422671,4917327,29395265,12361540
"2827","42367346930000",1976710.027,477029.9949,2010-06-01,395387,5312714,29395265,11806317
"2828","42367346930000",1976710.027,477029.9949,2010-07-01,405060,5717774,29395265,13014429
"2829","42367346930000",1976710.027,477029.9949,2010-08-01,437080,6154854,29395265,12894731
"2830","42367346930000",1976710.027,477029.9949,2010-09-01,402891,6557745,29395265,13014299
"2831","42367346930000",1976710.027,477029.9949,2010-10-01,459317,7017062,29395265,11689154
"2832","42367346930000",1976710.027,477029.9949,2010-11-01,439280,7456342,29395265,11954124
"2833","42367346930000",1976710.027,477029.9949,2010-12-01,460443,7916785,29395265,12386935
"2834","42367346930000",1976710.027,477029.9949,2011-01-01,479245,8396030,29395265,12491622
"2835","42367346930000",1976710.027,477029.9949,2011-02-01,352080,8748110,29395265,10744516
"2836","42367346930000",1976710.027,477029.9949,2011-03-01,437081,9185191,29395265,13585658
"2837","42367346930000",1976710.027,477029.9949,2011-04-01,382957,9568148,29395265,13823700
"2838","42367346930000",1976710.027,477029.9949,2011-05-01,388056,9956204,29395265,14893483
"2839","42367346930000",1976710.027,477029.9949,2011-06-01,370511,10326715,29395265,13536023
"2840","42367346930000",1976710.027,477029.9949,2011-07-01,366971,10693686,29395265,14060435
"2841","42367346930000",1976710.027,477029.9949,2011-08-01,363896,11057582,29395265,13865713
"2842","42367346930000",1976710.027,477029.9949,2011-09-01,372333,11429915,29395265,13575950
"2843","42367346930000",1976710.027,477029.9949,2011-10-01,348441,11778356,29395265,14224672
"2844","42367346930000",1976710.027,477029.9949,2011-11-01,363981,12142337,29395265,14289379
"2845","42367346930000",1976710.027,477029.9949,2011-12-01,344908,12487245,29395265,14301497
"2846","42367346930000",1976710.027,477029.9949,2012-01-01,324792,12812037,29395265,14393197
"2847","42367346930000",1976710.027,477029.9949,2012-02-01,379821,13191858,29395265,13261820
"2848","42367346930000",1976710.027,477029.9949,2012-03-01,387424,13579282,29395265,14719295
"2849","42367346930000",1976710.027,477029.9949,2012-04-01,357564,13936846,29395265,13422939
"2850","42367346930000",1976710.027,477029.9949,2012-05-01,353789,14290635,29395265,13619470
"2851","42367346930000",1976710.027,477029.9949,2012-06-01,284387,14575022,29395265,12965656
"2852","42367346930000",1976710.027,477029.9949,2012-07-01,328306,14903328,29395265,13735215
"2853","42367346930000",1976710.027,477029.9949,2012-08-01,236995,15140323,29395265,13116786
"2854","42367346930000",1976710.027,477029.9949,2012-09-01,279663,15419986,29395265,12508392
"2855","42367346930000",1976710.027,477029.9949,2012-10-01,243336,15663322,29395265,12829987
"2856","42367346930000",1976710.027,477029.9949,2012-11-01,258318,15921640,29395265,11811242
"2857","42367346930000",1976710.027,477029.9949,2012-12-01,260866,16182506,29395265,12077125
"2858","42367346930000",1976710.027,477029.9949,2013-01-01,254470,16436976,29395265,12754328
"2859","42367346930000",1976710.027,477029.9949,2013-02-01,215698,16652674,29395265,11309584
"2860","42367346930000",1976710.027,477029.9949,2013-03-01,260652,16913326,29395265,12445227
"2861","42367346930000",1976710.027,477029.9949,2013-04-01,256958,17170284,29395265,11899338
"2862","42367346930000",1976710.027,477029.9949,2013-05-01,262456,17432740,29395265,11963242
"2863","42367346930000",1976710.027,477029.9949,2013-06-01,267750,17700490,29395265,11514151
"2864","42367346930000",1976710.027,477029.9949,2013-07-01,253021,17953511,29395265,12334827
"2865","42367346930000",1976710.027,477029.9949,2013-08-01,354448,18307959,29395265,12036527
"2866","42367346930000",1976710.027,477029.9949,2013-09-01,352124,18660083,29395265,11831621
"2867","42367346930000",1976710.027,477029.9949,2013-10-01,375059,19035142,29395265,11912081
"2868","42367346930000",1976710.027,477029.9949,2013-11-01,345937,19381079,29395265,11402351
"2869","42367346930000",1976710.027,477029.9949,2013-12-01,266307,19647386,29395265,10800800
"2870","42367346930000",1976710.027,477029.9949,2014-01-01,209522,19856908,29395265,11386084
"2871","42367346930000",1976710.027,477029.9949,2014-02-01,213945,20070853,29395265,9936683
"2872","42367346930000",1976710.027,477029.9949,2014-03-01,241014,20311867,29395265,12046987
"2873","42367346930000",1976710.027,477029.9949,2014-04-01,237100,20548967,29395265,11738869
"2874","42367346930000",1976710.027,477029.9949,2014-05-01,243164,20792131,29395265,12165041
"2875","42367346930000",1976710.027,477029.9949,2014-06-01,208241,21000372,29395265,11720072
"2876","42367346930000",1976710.027,477029.9949,2014-07-01,157196,21157568,29395265,11632955
"2877","42367346930000",1976710.027,477029.9949,2014-08-01,149821,21307389,29395265,11280396
"2878","42367346930000",1976710.027,477029.9949,2014-09-01,203389,21510778,29395265,10707843
"2879","42367346930000",1976710.027,477029.9949,2014-10-01,185265,21696043,29395265,11154961
"2880","42367346930000",1976710.027,477029.9949,2014-11-01,181062,21877105,29395265,11006198
"2881","42367346930000",1976710.027,477029.9949,2014-12-01,78711,21955816,29395265,11175048
"2882","42367346930000",1976710.027,477029.9949,2015-01-01,83,21955899,29395265,11188192
"2883","42367346930000",1976710.027,477029.9949,2015-02-01,55599,22011498,29395265,9285348
"2884","42367346930000",1976710.027,477029.9949,2015-03-01,194724,22206222,29395265,11132951
"2885","42367346930000",1976710.027,477029.9949,2015-04-01,200738,22406960,29395265,10228970
"2886","42367346930000",1976710.027,477029.9949,2015-05-01,215944,22622904,29395265,10731832
"2887","42367346930000",1976710.027,477029.9949,2015-06-01,244956,22867860,29395265,10019178
"2888","42367346930000",1976710.027,477029.9949,2015-07-01,245299,23113159,29395265,9556838
"2889","42367346930000",1976710.027,477029.9949,2015-08-01,256621,23369780,29395265,9046352
"2890","42367346930000",1976710.027,477029.9949,2015-09-01,211193,23580973,29395265,8436833
"2891","42367346930000",1976710.027,477029.9949,2015-10-01,305677,23886650,29395265,8702949
"2892","42367346930000",1976710.027,477029.9949,2015-11-01,251338,24137988,29395265,8702391
"2893","42367346930000",1976710.027,477029.9949,2015-12-01,237325,24375313,29395265,8797617
"2894","42367346930000",1976710.027,477029.9949,2016-01-01,276263,24651576,29395265,8785697
"2895","42367346930000",1976710.027,477029.9949,2016-02-01,238549,24890125,29395265,8098391
"2896","42367346930000",1976710.027,477029.9949,2016-03-01,251534,25141659,29395265,8313445
"2897","42367346930000",1976710.027,477029.9949,2016-04-01,259454,25401113,29395265,8067410
"2898","42367346930000",1976710.027,477029.9949,2016-05-01,252334,25653447,29395265,8687363
"2899","42367346930000",1976710.027,477029.9949,2016-06-01,246404,25899851,29395265,8474598
"2900","42367346930000",1976710.027,477029.9949,2016-07-01,244984,26144835,29395265,8474294
"2901","42367346930000",1976710.027,477029.9949,2016-08-01,248780,26393615,29395265,8424724
"2902","42367346930000",1976710.027,477029.9949,2016-09-01,235016,26628631,29395265,7958587
"2903","42367346930000",1976710.027,477029.9949,2016-10-01,227404,26856035,29395265,7328643
"2904","42367346930000",1976710.027,477029.9949,2016-11-01,237673,27093708,29395265,7108192
"2905","42367346930000",1976710.027,477029.9949,2016-12-01,243711,27337419,29395265,7206177
"2906","42367346930000",1976710.027,477029.9949,2017-01-01,248336,27585755,29395265,8191419
"2907","42367346930000",1976710.027,477029.9949,2017-02-01,220019,27805774,29395265,7284679
"2908","42367346930000",1976710.027,477029.9949,2017-03-01,243460,28049234,29395265,7793859
"2909","42367346930000",1976710.027,477029.9949,2017-04-01,219047,28268281,29395265,7558837
"2910","42367346930000",1976710.027,477029.9949,2017-05-01,245660,28513941,29395265,7868617
"2911","42367346930000",1976710.027,477029.9949,2017-06-01,220081,28734022,29395265,7593200
"2912","42367346930000",1976710.027,477029.9949,2017-07-01,231465,28965487,29395265,8034023
"2913","42367346930000",1976710.027,477029.9949,2017-08-01,221041,29186528,29395265,8259439
"2914","42367346930000",1976710.027,477029.9949,2017-09-01,208737,29395265,29395265,7833970
"2915","42425301220000",1961684.361,227719.5151,2006-11-01,116926,116926,21877335,3240926
"2916","42425301220000",1961684.361,227719.5151,2006-12-01,231224,348150,21877335,4484941
"2917","42425301220000",1961684.361,227719.5151,2007-01-01,287372,635522,21877335,4380773
"2918","42425301220000",1961684.361,227719.5151,2007-02-01,272757,908279,21877335,4175393
"2919","42425301220000",1961684.361,227719.5151,2007-03-01,383303,1291582,21877335,4620840
"2920","42425301220000",1961684.361,227719.5151,2007-04-01,366826,1658408,21877335,4876542
"2921","42425301220000",1961684.361,227719.5151,2007-05-01,32984,1691392,21877335,5347071
"2922","42425301220000",1961684.361,227719.5151,2007-06-01,180818,1872210,21877335,5055569
"2923","42425301220000",1961684.361,227719.5151,2007-07-01,266234,2138444,21877335,5639953
"2924","42425301220000",1961684.361,227719.5151,2007-08-01,337493,2475937,21877335,5967755
"2925","42425301220000",1961684.361,227719.5151,2007-09-01,293701,2769638,21877335,5629384
"2926","42425301220000",1961684.361,227719.5151,2007-10-01,323069,3092707,21877335,6483309
"2927","42425301220000",1961684.361,227719.5151,2007-11-01,388447,3481154,21877335,6157035
"2928","42425301220000",1961684.361,227719.5151,2007-12-01,291076,3772230,21877335,5777613
"2929","42425301220000",1961684.361,227719.5151,2008-01-01,217085,3989315,21877335,6452815
"2930","42425301220000",1961684.361,227719.5151,2008-02-01,320128,4309443,21877335,7775520
"2931","42425301220000",1961684.361,227719.5151,2008-03-01,369315,4678758,21877335,9152519
"2932","42425301220000",1961684.361,227719.5151,2008-04-01,327396,5006154,21877335,8881211
"2933","42425301220000",1961684.361,227719.5151,2008-05-01,405746,5411900,21877335,9790992
"2934","42425301220000",1961684.361,227719.5151,2008-06-01,384251,5796151,21877335,9489076
"2935","42425301220000",1961684.361,227719.5151,2008-07-01,314282,6110433,21877335,9342850
"2936","42425301220000",1961684.361,227719.5151,2008-08-01,313805,6424238,21877335,9977335
"2937","42425301220000",1961684.361,227719.5151,2008-09-01,119232,6543470,21877335,9513587
"2938","42425301220000",1961684.361,227719.5151,2008-10-01,363740,6907210,21877335,9729575
"2939","42425301220000",1961684.361,227719.5151,2008-11-01,296664,7203874,21877335,10178583
"2940","42425301220000",1961684.361,227719.5151,2008-12-01,165388,7369262,21877335,9857864
"2941","42425301220000",1961684.361,227719.5151,2009-01-01,234488,7603750,21877335,9714975
"2942","42425301220000",1961684.361,227719.5151,2009-02-01,165150,7768900,21877335,9563848
"2943","42425301220000",1961684.361,227719.5151,2009-03-01,129681,7898581,21877335,10011008
"2944","42425301220000",1961684.361,227719.5151,2009-04-01,160859,8059440,21877335,8817835
"2945","42425301220000",1961684.361,227719.5151,2009-05-01,203800,8263240,21877335,9222275
"2946","42425301220000",1961684.361,227719.5151,2009-06-01,234383,8497623,21877335,8823798
"2947","42425301220000",1961684.361,227719.5151,2009-07-01,208207,8705830,21877335,9681047
"2948","42425301220000",1961684.361,227719.5151,2009-08-01,155714,8861544,21877335,10148823
"2949","42425301220000",1961684.361,227719.5151,2009-09-01,133793,8995337,21877335,9880092
"2950","42425301220000",1961684.361,227719.5151,2009-10-01,118598,9113935,21877335,10866851
"2951","42425301220000",1961684.361,227719.5151,2009-11-01,119327,9233262,21877335,10107974
"2952","42425301220000",1961684.361,227719.5151,2009-12-01,93441,9326703,21877335,10176315
"2953","42425301220000",1961684.361,227719.5151,2010-01-01,40487,9367190,21877335,10900701
"2954","42425301220000",1961684.361,227719.5151,2010-02-01,97198,9464388,21877335,10320596
"2955","42425301220000",1961684.361,227719.5151,2010-03-01,145070,9609458,21877335,12054256
"2956","42425301220000",1961684.361,227719.5151,2010-04-01,55698,9665156,21877335,11657482
"2957","42425301220000",1961684.361,227719.5151,2010-05-01,133092,9798248,21877335,12361540
"2958","42425301220000",1961684.361,227719.5151,2010-06-01,40007,9838255,21877335,11806317
"2959","42425301220000",1961684.361,227719.5151,2010-07-01,51553,9889808,21877335,13014429
"2960","42425301220000",1961684.361,227719.5151,2010-08-01,123006,10012814,21877335,12894731
"2961","42425301220000",1961684.361,227719.5151,2010-09-01,103396,10116210,21877335,13014299
"2962","42425301220000",1961684.361,227719.5151,2010-10-01,93294,10209504,21877335,11689154
"2963","42425301220000",1961684.361,227719.5151,2010-11-01,125605,10335109,21877335,11954124
"2964","42425301220000",1961684.361,227719.5151,2010-12-01,114531,10449640,21877335,12386935
"2965","42425301220000",1961684.361,227719.5151,2011-01-01,112532,10562172,21877335,12491622
"2966","42425301220000",1961684.361,227719.5151,2011-02-01,87138,10649310,21877335,10744516
"2967","42425301220000",1961684.361,227719.5151,2011-03-01,110191,10759501,21877335,13585658
"2968","42425301220000",1961684.361,227719.5151,2011-04-01,162996,10922497,21877335,13823700
"2969","42425301220000",1961684.361,227719.5151,2011-05-01,130037,11052534,21877335,14893483
"2970","42425301220000",1961684.361,227719.5151,2011-06-01,178491,11231025,21877335,13536023
"2971","42425301220000",1961684.361,227719.5151,2011-07-01,129927,11360952,21877335,14060435
"2972","42425301220000",1961684.361,227719.5151,2011-08-01,133472,11494424,21877335,13865713
"2973","42425301220000",1961684.361,227719.5151,2011-09-01,113201,11607625,21877335,13575950
"2974","42425301220000",1961684.361,227719.5151,2011-10-01,113812,11721437,21877335,14224672
"2975","42425301220000",1961684.361,227719.5151,2011-11-01,110270,11831707,21877335,14289379
"2976","42425301220000",1961684.361,227719.5151,2011-12-01,122558,11954265,21877335,14301497
"2977","42425301220000",1961684.361,227719.5151,2012-01-01,123485,12077750,21877335,14393197
"2978","42425301220000",1961684.361,227719.5151,2012-02-01,120565,12198315,21877335,13261820
"2979","42425301220000",1961684.361,227719.5151,2012-03-01,141667,12339982,21877335,14719295
"2980","42425301220000",1961684.361,227719.5151,2012-04-01,93038,12433020,21877335,13422939
"2981","42425301220000",1961684.361,227719.5151,2012-05-01,97668,12530688,21877335,13619470
"2982","42425301220000",1961684.361,227719.5151,2012-06-01,122089,12652777,21877335,12965656
"2983","42425301220000",1961684.361,227719.5151,2012-07-01,92916,12745693,21877335,13735215
"2984","42425301220000",1961684.361,227719.5151,2012-08-01,84089,12829782,21877335,13116786
"2985","42425301220000",1961684.361,227719.5151,2012-09-01,91934,12921716,21877335,12508392
"2986","42425301220000",1961684.361,227719.5151,2012-10-01,101566,13023282,21877335,12829987
"2987","42425301220000",1961684.361,227719.5151,2012-11-01,90971,13114253,21877335,11811242
"2988","42425301220000",1961684.361,227719.5151,2012-12-01,51746,13165999,21877335,12077125
"2989","42425301220000",1961684.361,227719.5151,2013-01-01,90612,13256611,21877335,12754328
"2990","42425301220000",1961684.361,227719.5151,2013-02-01,77690,13334301,21877335,11309584
"2991","42425301220000",1961684.361,227719.5151,2013-03-01,75509,13409810,21877335,12445227
"2992","42425301220000",1961684.361,227719.5151,2013-04-01,83530,13493340,21877335,11899338
"2993","42425301220000",1961684.361,227719.5151,2013-05-01,82974,13576314,21877335,11963242
"2994","42425301220000",1961684.361,227719.5151,2013-06-01,81787,13658101,21877335,11514151
"2995","42425301220000",1961684.361,227719.5151,2013-07-01,104049,13762150,21877335,12334827
"2996","42425301220000",1961684.361,227719.5151,2013-08-01,115847,13877997,21877335,12036527
"2997","42425301220000",1961684.361,227719.5151,2013-09-01,106190,13984187,21877335,11831621
"2998","42425301220000",1961684.361,227719.5151,2013-10-01,75509,14059696,21877335,11912081
"2999","42425301220000",1961684.361,227719.5151,2013-11-01,77690,14137386,21877335,11402351
"3000","42425301220000",1961684.361,227719.5151,2013-12-01,90612,14227998,21877335,10800800
"3001","42425301220000",1961684.361,227719.5151,2014-01-01,100883,14328881,21877335,11386084
"3002","42425301220000",1961684.361,227719.5151,2014-02-01,94489,14423370,21877335,9936683
"3003","42425301220000",1961684.361,227719.5151,2014-03-01,103316,14526686,21877335,12046987
"3004","42425301220000",1961684.361,227719.5151,2014-04-01,275250,14801936,21877335,11738869
"3005","42425301220000",1961684.361,227719.5151,2014-05-01,352295,15154231,21877335,12165041
"3006","42425301220000",1961684.361,227719.5151,2014-06-01,337080,15491311,21877335,11720072
"3007","42425301220000",1961684.361,227719.5151,2014-07-01,314420,15805731,21877335,11632955
"3008","42425301220000",1961684.361,227719.5151,2014-08-01,317414,16123145,21877335,11280396
"3009","42425301220000",1961684.361,227719.5151,2014-09-01,293700,16416845,21877335,10707843
"3010","42425301220000",1961684.361,227719.5151,2014-10-01,326563,16743408,21877335,11154961
"3011","42425301220000",1961684.361,227719.5151,2014-11-01,234754,16978162,21877335,11006198
"3012","42425301220000",1961684.361,227719.5151,2014-12-01,241820,17219982,21877335,11175048
"3013","42425301220000",1961684.361,227719.5151,2015-01-01,280037,17500019,21877335,11188192
"3014","42425301220000",1961684.361,227719.5151,2015-02-01,193424,17693443,21877335,9285348
"3015","42425301220000",1961684.361,227719.5151,2015-03-01,158882,17852325,21877335,11132951
"3016","42425301220000",1961684.361,227719.5151,2015-04-01,148827,18001152,21877335,10228970
"3017","42425301220000",1961684.361,227719.5151,2015-05-01,142906,18144058,21877335,10731832
"3018","42425301220000",1961684.361,227719.5151,2015-06-01,125013,18269071,21877335,10019178
"3019","42425301220000",1961684.361,227719.5151,2015-07-01,133480,18402551,21877335,9556838
"3020","42425301220000",1961684.361,227719.5151,2015-08-01,130737,18533288,21877335,9046352
"3021","42425301220000",1961684.361,227719.5151,2015-09-01,129136,18662424,21877335,8436833
"3022","42425301220000",1961684.361,227719.5151,2015-10-01,125707,18788131,21877335,8702949
"3023","42425301220000",1961684.361,227719.5151,2015-11-01,123212,18911343,21877335,8702391
"3024","42425301220000",1961684.361,227719.5151,2015-12-01,117470,19028813,21877335,8797617
"3025","42425301220000",1961684.361,227719.5151,2016-01-01,112629,19141442,21877335,8785697
"3026","42425301220000",1961684.361,227719.5151,2016-02-01,96717,19238159,21877335,8098391
"3027","42425301220000",1961684.361,227719.5151,2016-03-01,108828,19346987,21877335,8313445
"3028","42425301220000",1961684.361,227719.5151,2016-04-01,110563,19457550,21877335,8067410
"3029","42425301220000",1961684.361,227719.5151,2016-05-01,156517,19614067,21877335,8687363
"3030","42425301220000",1961684.361,227719.5151,2016-06-01,171348,19785415,21877335,8474598
"3031","42425301220000",1961684.361,227719.5151,2016-07-01,240172,20025587,21877335,8474294
"3032","42425301220000",1961684.361,227719.5151,2016-08-01,326075,20351662,21877335,8424724
"3033","42425301220000",1961684.361,227719.5151,2016-09-01,222653,20574315,21877335,7958587
"3034","42425301220000",1961684.361,227719.5151,2017-01-01,133935,20708250,21877335,8191419
"3035","42425301220000",1961684.361,227719.5151,2017-02-01,147018,20855268,21877335,7284679
"3036","42425301220000",1961684.361,227719.5151,2017-03-01,133841,20989109,21877335,7793859
"3037","42425301220000",1961684.361,227719.5151,2017-04-01,145351,21134460,21877335,7558837
"3038","42425301220000",1961684.361,227719.5151,2017-05-01,205232,21339692,21877335,7868617
"3039","42425301220000",1961684.361,227719.5151,2017-06-01,127318,21467010,21877335,7593200
"3040","42425301220000",1961684.361,227719.5151,2017-07-01,115198,21582208,21877335,8034023
"3041","42425301220000",1961684.361,227719.5151,2017-08-01,142491,21724699,21877335,8259439
"3042","42425301220000",1961684.361,227719.5151,2017-09-01,152636,21877335,21877335,7833970
"3043","42439312280000",2021976.184,478982.6817,2005-11-01,86830,86830,71012567,1075049
"3044","42439312280000",2021976.184,478982.6817,2005-12-01,151180,238010,71012567,1200947
"3045","42439312280000",2021976.184,478982.6817,2006-01-01,241135,479145,71012567,1350182
"3046","42439312280000",2021976.184,478982.6817,2006-02-01,257030,736175,71012567,1472478
"3047","42439312280000",2021976.184,478982.6817,2006-03-01,332685,1068860,71012567,1848901
"3048","42439312280000",2021976.184,478982.6817,2006-04-01,301750,1370610,71012567,1923527
"3049","42439312280000",2021976.184,478982.6817,2006-05-01,288265,1658875,71012567,2207406
"3050","42439312280000",2021976.184,478982.6817,2006-06-01,287085,1945960,71012567,1973653
"3051","42439312280000",2021976.184,478982.6817,2006-07-01,275220,2221180,71012567,2021893
"3052","42439312280000",2021976.184,478982.6817,2006-08-01,66490,2287670,71012567,2512715
"3053","42439312280000",2021976.184,478982.6817,2006-09-01,194990,2482660,71012567,2773616
"3054","42439312280000",2021976.184,478982.6817,2006-10-01,152151,2634811,71012567,3124548
"3055","42439312280000",2021976.184,478982.6817,2006-11-01,31866,2666677,71012567,3240926
"3056","42439312280000",2021976.184,478982.6817,2006-12-01,175734,2842411,71012567,4484941
"3057","42439312280000",2021976.184,478982.6817,2007-01-01,321645,3164056,71012567,4380773
"3058","42439312280000",2021976.184,478982.6817,2007-02-01,301703,3465759,71012567,4175393
"3059","42439312280000",2021976.184,478982.6817,2007-03-01,317346,3783105,71012567,4620840
"3060","42439312280000",2021976.184,478982.6817,2007-04-01,308404,4091509,71012567,4876542
"3061","42439312280000",2021976.184,478982.6817,2007-05-01,304740,4396249,71012567,5347071
"3062","42439312280000",2021976.184,478982.6817,2007-06-01,310475,4706724,71012567,5055569
"3063","42439312280000",2021976.184,478982.6817,2007-07-01,315506,5022230,71012567,5639953
"3064","42439312280000",2021976.184,478982.6817,2007-08-01,308413,5330643,71012567,5967755
"3065","42439312280000",2021976.184,478982.6817,2007-09-01,289961,5620604,71012567,5629384
"3066","42439312280000",2021976.184,478982.6817,2007-10-01,302925,5923529,71012567,6483309
"3067","42439312280000",2021976.184,478982.6817,2007-11-01,286476,6210005,71012567,6157035
"3068","42439312280000",2021976.184,478982.6817,2007-12-01,310608,6520613,71012567,5777613
"3069","42439312280000",2021976.184,478982.6817,2008-01-01,320765,6841378,71012567,6452815
"3070","42439312280000",2021976.184,478982.6817,2008-02-01,288740,7130118,71012567,7775520
"3071","42439312280000",2021976.184,478982.6817,2008-03-01,311160,7441278,71012567,9152519
"3072","42439312280000",2021976.184,478982.6817,2008-04-01,296975,7738253,71012567,8881211
"3073","42439312280000",2021976.184,478982.6817,2008-05-01,305290,8043543,71012567,9790992
"3074","42439312280000",2021976.184,478982.6817,2008-06-01,293415,8336958,71012567,9489076
"3075","42439312280000",2021976.184,478982.6817,2008-07-01,241815,8578773,71012567,9342850
"3076","42439312280000",2021976.184,478982.6817,2008-08-01,180720,8759493,71012567,9977335
"3077","42439312280000",2021976.184,478982.6817,2008-09-01,566425,9325918,71012567,9513587
"3078","42439312280000",2021976.184,478982.6817,2008-10-01,715895,10041813,71012567,9729575
"3079","42439312280000",2021976.184,478982.6817,2008-11-01,689390,10731203,71012567,10178583
"3080","42439312280000",2021976.184,478982.6817,2008-12-01,651760,11382963,71012567,9857864
"3081","42439312280000",2021976.184,478982.6817,2009-01-01,406795,11789758,71012567,9714975
"3082","42439312280000",2021976.184,478982.6817,2009-02-01,504554,12294312,71012567,9563848
"3083","42439312280000",2021976.184,478982.6817,2009-03-01,641699,12936011,71012567,10011008
"3084","42439312280000",2021976.184,478982.6817,2009-04-01,45409,12981420,71012567,8817835
"3085","42439312280000",2021976.184,478982.6817,2009-05-01,546558,13527978,71012567,9222275
"3086","42439312280000",2021976.184,478982.6817,2009-06-01,440742,13968720,71012567,8823798
"3087","42439312280000",2021976.184,478982.6817,2009-07-01,589136,14557856,71012567,9681047
"3088","42439312280000",2021976.184,478982.6817,2009-08-01,314440,14872296,71012567,10148823
"3089","42439312280000",2021976.184,478982.6817,2009-09-01,227491,15099787,71012567,9880092
"3090","42439312280000",2021976.184,478982.6817,2009-10-01,643189,15742976,71012567,10866851
"3091","42439312280000",2021976.184,478982.6817,2009-11-01,579584,16322560,71012567,10107974
"3092","42439312280000",2021976.184,478982.6817,2009-12-01,607531,16930091,71012567,10176315
"3093","42439312280000",2021976.184,478982.6817,2010-01-01,647041,17577132,71012567,10900701
"3094","42439312280000",2021976.184,478982.6817,2010-02-01,620311,18197443,71012567,10320596
"3095","42439312280000",2021976.184,478982.6817,2010-03-01,720523,18917966,71012567,12054256
"3096","42439312280000",2021976.184,478982.6817,2010-04-01,697359,19615325,71012567,11657482
"3097","42439312280000",2021976.184,478982.6817,2010-05-01,623755,20239080,71012567,12361540
"3098","42439312280000",2021976.184,478982.6817,2010-06-01,455002,20694082,71012567,11806317
"3099","42439312280000",2021976.184,478982.6817,2010-07-01,722121,21416203,71012567,13014429
"3100","42439312280000",2021976.184,478982.6817,2010-08-01,700192,22116395,71012567,12894731
"3101","42439312280000",2021976.184,478982.6817,2010-09-01,659311,22775706,71012567,13014299
"3102","42439312280000",2021976.184,478982.6817,2010-10-01,668328,23444034,71012567,11689154
"3103","42439312280000",2021976.184,478982.6817,2010-11-01,680439,24124473,71012567,11954124
"3104","42439312280000",2021976.184,478982.6817,2010-12-01,694116,24818589,71012567,12386935
"3105","42439312280000",2021976.184,478982.6817,2011-01-01,673168,25491757,71012567,12491622
"3106","42439312280000",2021976.184,478982.6817,2011-02-01,489225,25980982,71012567,10744516
"3107","42439312280000",2021976.184,478982.6817,2011-03-01,626289,26607271,71012567,13585658
"3108","42439312280000",2021976.184,478982.6817,2011-04-01,576682,27183953,71012567,13823700
"3109","42439312280000",2021976.184,478982.6817,2011-05-01,579163,27763116,71012567,14893483
"3110","42439312280000",2021976.184,478982.6817,2011-06-01,552720,28315836,71012567,13536023
"3111","42439312280000",2021976.184,478982.6817,2011-07-01,561743,28877579,71012567,14060435
"3112","42439312280000",2021976.184,478982.6817,2011-08-01,490793,29368372,71012567,13865713
"3113","42439312280000",2021976.184,478982.6817,2011-09-01,421634,29790006,71012567,13575950
"3114","42439312280000",2021976.184,478982.6817,2011-10-01,640693,30430699,71012567,14224672
"3115","42439312280000",2021976.184,478982.6817,2011-11-01,607687,31038386,71012567,14289379
"3116","42439312280000",2021976.184,478982.6817,2011-12-01,613109,31651495,71012567,14301497
"3117","42439312280000",2021976.184,478982.6817,2012-01-01,671001,32322496,71012567,14393197
"3118","42439312280000",2021976.184,478982.6817,2012-02-01,617233,32939729,71012567,13261820
"3119","42439312280000",2021976.184,478982.6817,2012-03-01,673693,33613422,71012567,14719295
"3120","42439312280000",2021976.184,478982.6817,2012-04-01,635100,34248522,71012567,13422939
"3121","42439312280000",2021976.184,478982.6817,2012-05-01,689624,34938146,71012567,13619470
"3122","42439312280000",2021976.184,478982.6817,2012-06-01,657834,35595980,71012567,12965656
"3123","42439312280000",2021976.184,478982.6817,2012-07-01,707063,36303043,71012567,13735215
"3124","42439312280000",2021976.184,478982.6817,2012-08-01,669458,36972501,71012567,13116786
"3125","42439312280000",2021976.184,478982.6817,2012-09-01,650815,37623316,71012567,12508392
"3126","42439312280000",2021976.184,478982.6817,2012-10-01,677438,38300754,71012567,12829987
"3127","42439312280000",2021976.184,478982.6817,2012-11-01,641053,38941807,71012567,11811242
"3128","42439312280000",2021976.184,478982.6817,2012-12-01,646147,39587954,71012567,12077125
"3129","42439312280000",2021976.184,478982.6817,2013-01-01,654166,40242120,71012567,12754328
"3130","42439312280000",2021976.184,478982.6817,2013-02-01,654166,40896286,71012567,11309584
"3131","42439312280000",2021976.184,478982.6817,2013-03-01,687018,41583304,71012567,12445227
"3132","42439312280000",2021976.184,478982.6817,2013-04-01,642186,42225490,71012567,11899338
"3133","42439312280000",2021976.184,478982.6817,2013-05-01,662654,42888144,71012567,11963242
"3134","42439312280000",2021976.184,478982.6817,2013-06-01,634333,43522477,71012567,11514151
"3135","42439312280000",2021976.184,478982.6817,2013-07-01,575092,44097569,71012567,12334827
"3136","42439312280000",2021976.184,478982.6817,2013-08-01,582698,44680267,71012567,12036527
"3137","42439312280000",2021976.184,478982.6817,2013-09-01,591801,45272068,71012567,11831621
"3138","42439312280000",2021976.184,478982.6817,2013-10-01,629513,45901581,71012567,11912081
"3139","42439312280000",2021976.184,478982.6817,2013-11-01,609661,46511242,71012567,11402351
"3140","42439312280000",2021976.184,478982.6817,2013-12-01,547773,47059015,71012567,10800800
"3141","42439312280000",2021976.184,478982.6817,2014-01-01,605982,47664997,71012567,11386084
"3142","42439312280000",2021976.184,478982.6817,2014-02-01,598856,48263853,71012567,9936683
"3143","42439312280000",2021976.184,478982.6817,2014-03-01,651321,48915174,71012567,12046987
"3144","42439312280000",2021976.184,478982.6817,2014-04-01,624267,49539441,71012567,11738869
"3145","42439312280000",2021976.184,478982.6817,2014-05-01,627905,50167346,71012567,12165041
"3146","42439312280000",2021976.184,478982.6817,2014-06-01,631121,50798467,71012567,11720072
"3147","42439312280000",2021976.184,478982.6817,2014-07-01,670662,51469129,71012567,11632955
"3148","42439312280000",2021976.184,478982.6817,2014-08-01,619657,52088786,71012567,11280396
"3149","42439312280000",2021976.184,478982.6817,2014-09-01,506594,52595380,71012567,10707843
"3150","42439312280000",2021976.184,478982.6817,2014-10-01,573900,53169280,71012567,11154961
"3151","42439312280000",2021976.184,478982.6817,2014-11-01,588926,53758206,71012567,11006198
"3152","42439312280000",2021976.184,478982.6817,2014-12-01,657353,54415559,71012567,11175048
"3153","42439312280000",2021976.184,478982.6817,2015-01-01,634606,55050165,71012567,11188192
"3154","42439312280000",2021976.184,478982.6817,2015-02-01,547058,55597223,71012567,9285348
"3155","42439312280000",2021976.184,478982.6817,2015-03-01,633389,56230612,71012567,11132951
"3156","42439312280000",2021976.184,478982.6817,2015-04-01,601586,56832198,71012567,10228970
"3157","42439312280000",2021976.184,478982.6817,2015-05-01,419356,57251554,71012567,10731832
"3158","42439312280000",2021976.184,478982.6817,2015-06-01,544604,57796158,71012567,10019178
"3159","42439312280000",2021976.184,478982.6817,2015-07-01,563984,58360142,71012567,9556838
"3160","42439312280000",2021976.184,478982.6817,2015-08-01,536750,58896892,71012567,9046352
"3161","42439312280000",2021976.184,478982.6817,2015-09-01,505505,59402397,71012567,8436833
"3162","42439312280000",2021976.184,478982.6817,2015-10-01,560154,59962551,71012567,8702949
"3163","42439312280000",2021976.184,478982.6817,2015-11-01,566394,60528945,71012567,8702391
"3164","42439312280000",2021976.184,478982.6817,2015-12-01,580255,61109200,71012567,8797617
"3165","42439312280000",2021976.184,478982.6817,2016-01-01,595677,61704877,71012567,8785697
"3166","42439312280000",2021976.184,478982.6817,2016-02-01,549986,62254863,71012567,8098391
"3167","42439312280000",2021976.184,478982.6817,2016-03-01,580473,62835336,71012567,8313445
"3168","42439312280000",2021976.184,478982.6817,2016-04-01,522779,63358115,71012567,8067410
"3169","42439312280000",2021976.184,478982.6817,2016-05-01,558493,63916608,71012567,8687363
"3170","42439312280000",2021976.184,478982.6817,2016-06-01,554292,64470900,71012567,8474598
"3171","42439312280000",2021976.184,478982.6817,2016-07-01,493184,64964084,71012567,8474294
"3172","42439312280000",2021976.184,478982.6817,2016-08-01,524454,65488538,71012567,8424724
"3173","42439312280000",2021976.184,478982.6817,2016-09-01,570056,66058594,71012567,7958587
"3174","42439312280000",2021976.184,478982.6817,2016-10-01,554053,66612647,71012567,7328643
"3175","42439312280000",2021976.184,478982.6817,2016-11-01,522846,67135493,71012567,7108192
"3176","42439312280000",2021976.184,478982.6817,2016-12-01,439698,67575191,71012567,7206177
"3177","42439312280000",2021976.184,478982.6817,2017-01-01,507295,68082486,71012567,8191419
"3178","42439312280000",2021976.184,478982.6817,2017-02-01,460863,68543349,71012567,7284679
"3179","42439312280000",2021976.184,478982.6817,2017-03-01,501245,69044594,71012567,7793859
"3180","42439312280000",2021976.184,478982.6817,2017-04-01,174148,69218742,71012567,7558837
"3181","42439312280000",2021976.184,478982.6817,2017-05-01,307726,69526468,71012567,7868617
"3182","42439312280000",2021976.184,478982.6817,2017-06-01,267959,69794427,71012567,7593200
"3183","42439312280000",2021976.184,478982.6817,2017-07-01,365329,70159756,71012567,8034023
"3184","42439312280000",2021976.184,478982.6817,2017-08-01,417022,70576778,71012567,8259439
"3185","42439312280000",2021976.184,478982.6817,2017-09-01,435789,71012567,71012567,7833970
"3186","42439324660000",1992702.846,373188.1053,2008-01-01,9470,9470,50469264,6452815
"3187","42439324660000",1992702.846,373188.1053,2008-02-01,49006,58476,50469264,7775520
"3188","42439324660000",1992702.846,373188.1053,2008-03-01,228604,287080,50469264,9152519
"3189","42439324660000",1992702.846,373188.1053,2008-04-01,276064,563144,50469264,8881211
"3190","42439324660000",1992702.846,373188.1053,2008-05-01,242477,805621,50469264,9790992
"3191","42439324660000",1992702.846,373188.1053,2008-06-01,198320,1003941,50469264,9489076
"3192","42439324660000",1992702.846,373188.1053,2008-07-01,224116,1228057,50469264,9342850
"3193","42439324660000",1992702.846,373188.1053,2008-08-01,210703,1438760,50469264,9977335
"3194","42439324660000",1992702.846,373188.1053,2008-09-01,254781,1693541,50469264,9513587
"3195","42439324660000",1992702.846,373188.1053,2009-10-01,233014,1926555,50469264,10866851
"3196","42439324660000",1992702.846,373188.1053,2009-11-01,190775,2117330,50469264,10107974
"3197","42439324660000",1992702.846,373188.1053,2009-12-01,196683,2314013,50469264,10176315
"3198","42439324660000",1992702.846,373188.1053,2010-01-01,241942,2555955,50469264,10900701
"3199","42439324660000",1992702.846,373188.1053,2010-02-01,261375,2817330,50469264,10320596
"3200","42439324660000",1992702.846,373188.1053,2010-03-01,460998,3278328,50469264,12054256
"3201","42439324660000",1992702.846,373188.1053,2010-04-01,472645,3750973,50469264,11657482
"3202","42439324660000",1992702.846,373188.1053,2010-05-01,500795,4251768,50469264,12361540
"3203","42439324660000",1992702.846,373188.1053,2010-06-01,441624,4693392,50469264,11806317
"3204","42439324660000",1992702.846,373188.1053,2010-07-01,436144,5129536,50469264,13014429
"3205","42439324660000",1992702.846,373188.1053,2010-08-01,378654,5508190,50469264,12894731
"3206","42439324660000",1992702.846,373188.1053,2010-09-01,471235,5979425,50469264,13014299
"3207","42439324660000",1992702.846,373188.1053,2010-10-01,522283,6501708,50469264,11689154
"3208","42439324660000",1992702.846,373188.1053,2010-11-01,492699,6994407,50469264,11954124
"3209","42439324660000",1992702.846,373188.1053,2010-12-01,546493,7540900,50469264,12386935
"3210","42439324660000",1992702.846,373188.1053,2011-01-01,470745,8011645,50469264,12491622
"3211","42439324660000",1992702.846,373188.1053,2011-02-01,414652,8426297,50469264,10744516
"3212","42439324660000",1992702.846,373188.1053,2011-03-01,551455,8977752,50469264,13585658
"3213","42439324660000",1992702.846,373188.1053,2011-04-01,506772,9484524,50469264,13823700
"3214","42439324660000",1992702.846,373188.1053,2011-05-01,599004,10083528,50469264,14893483
"3215","42439324660000",1992702.846,373188.1053,2011-06-01,507357,10590885,50469264,13536023
"3216","42439324660000",1992702.846,373188.1053,2011-07-01,483376,11074261,50469264,14060435
"3217","42439324660000",1992702.846,373188.1053,2011-08-01,533142,11607403,50469264,13865713
"3218","42439324660000",1992702.846,373188.1053,2011-09-01,472049,12079452,50469264,13575950
"3219","42439324660000",1992702.846,373188.1053,2011-10-01,584195,12663647,50469264,14224672
"3220","42439324660000",1992702.846,373188.1053,2011-11-01,650948,13314595,50469264,14289379
"3221","42439324660000",1992702.846,373188.1053,2011-12-01,554908,13869503,50469264,14301497
"3222","42439324660000",1992702.846,373188.1053,2012-01-01,596005,14465508,50469264,14393197
"3223","42439324660000",1992702.846,373188.1053,2012-02-01,588265,15053773,50469264,13261820
"3224","42439324660000",1992702.846,373188.1053,2012-03-01,577617,15631390,50469264,14719295
"3225","42439324660000",1992702.846,373188.1053,2012-04-01,529331,16160721,50469264,13422939
"3226","42439324660000",1992702.846,373188.1053,2012-05-01,555840,16716561,50469264,13619470
"3227","42439324660000",1992702.846,373188.1053,2012-06-01,494655,17211216,50469264,12965656
"3228","42439324660000",1992702.846,373188.1053,2012-07-01,558795,17770011,50469264,13735215
"3229","42439324660000",1992702.846,373188.1053,2012-08-01,492920,18262931,50469264,13116786
"3230","42439324660000",1992702.846,373188.1053,2012-09-01,527043,18789974,50469264,12508392
"3231","42439324660000",1992702.846,373188.1053,2012-10-01,474658,19264632,50469264,12829987
"3232","42439324660000",1992702.846,373188.1053,2012-11-01,402482,19667114,50469264,11811242
"3233","42439324660000",1992702.846,373188.1053,2012-12-01,436717,20103831,50469264,12077125
"3234","42439324660000",1992702.846,373188.1053,2013-01-01,501463,20605294,50469264,12754328
"3235","42439324660000",1992702.846,373188.1053,2013-02-01,480448,21085742,50469264,11309584
"3236","42439324660000",1992702.846,373188.1053,2013-03-01,551173,21636915,50469264,12445227
"3237","42439324660000",1992702.846,373188.1053,2013-04-01,433299,22070214,50469264,11899338
"3238","42439324660000",1992702.846,373188.1053,2013-05-01,580439,22650653,50469264,11963242
"3239","42439324660000",1992702.846,373188.1053,2013-06-01,555692,23206345,50469264,11514151
"3240","42439324660000",1992702.846,373188.1053,2013-07-01,634373,23840718,50469264,12334827
"3241","42439324660000",1992702.846,373188.1053,2013-08-01,623326,24464044,50469264,12036527
"3242","42439324660000",1992702.846,373188.1053,2013-09-01,594347,25058391,50469264,11831621
"3243","42439324660000",1992702.846,373188.1053,2013-10-01,611172,25669563,50469264,11912081
"3244","42439324660000",1992702.846,373188.1053,2013-11-01,533092,26202655,50469264,11402351
"3245","42439324660000",1992702.846,373188.1053,2013-12-01,498087,26700742,50469264,10800800
"3246","42439324660000",1992702.846,373188.1053,2014-01-01,676254,27376996,50469264,11386084
"3247","42439324660000",1992702.846,373188.1053,2014-02-01,620459,27997455,50469264,9936683
"3248","42439324660000",1992702.846,373188.1053,2014-03-01,594806,28592261,50469264,12046987
"3249","42439324660000",1992702.846,373188.1053,2014-04-01,501611,29093872,50469264,11738869
"3250","42439324660000",1992702.846,373188.1053,2014-05-01,598514,29692386,50469264,12165041
"3251","42439324660000",1992702.846,373188.1053,2014-06-01,617687,30310073,50469264,11720072
"3252","42439324660000",1992702.846,373188.1053,2014-07-01,655444,30965517,50469264,11632955
"3253","42439324660000",1992702.846,373188.1053,2014-08-01,653302,31618819,50469264,11280396
"3254","42439324660000",1992702.846,373188.1053,2014-09-01,635264,32254083,50469264,10707843
"3255","42439324660000",1992702.846,373188.1053,2014-10-01,611447,32865530,50469264,11154961
"3256","42439324660000",1992702.846,373188.1053,2014-11-01,640497,33506027,50469264,11006198
"3257","42439324660000",1992702.846,373188.1053,2014-12-01,618685,34124712,50469264,11175048
"3258","42439324660000",1992702.846,373188.1053,2015-01-01,615795,34740507,50469264,11188192
"3259","42439324660000",1992702.846,373188.1053,2015-02-01,256489,34996996,50469264,9285348
"3260","42439324660000",1992702.846,373188.1053,2015-03-01,610836,35607832,50469264,11132951
"3261","42439324660000",1992702.846,373188.1053,2015-04-01,569965,36177797,50469264,10228970
"3262","42439324660000",1992702.846,373188.1053,2015-05-01,611442,36789239,50469264,10731832
"3263","42439324660000",1992702.846,373188.1053,2015-06-01,539525,37328764,50469264,10019178
"3264","42439324660000",1992702.846,373188.1053,2015-07-01,522953,37851717,50469264,9556838
"3265","42439324660000",1992702.846,373188.1053,2015-08-01,538945,38390662,50469264,9046352
"3266","42439324660000",1992702.846,373188.1053,2015-09-01,573540,38964202,50469264,8436833
"3267","42439324660000",1992702.846,373188.1053,2016-01-01,309763,39273965,50469264,8785697
"3268","42439324660000",1992702.846,373188.1053,2016-02-01,607526,39881491,50469264,8098391
"3269","42439324660000",1992702.846,373188.1053,2016-03-01,636367,40517858,50469264,8313445
"3270","42439324660000",1992702.846,373188.1053,2016-04-01,649991,41167849,50469264,8067410
"3271","42439324660000",1992702.846,373188.1053,2016-05-01,680255,41848104,50469264,8687363
"3272","42439324660000",1992702.846,373188.1053,2016-06-01,676862,42524966,50469264,8474598
"3273","42439324660000",1992702.846,373188.1053,2016-07-01,693002,43217968,50469264,8474294
"3274","42439324660000",1992702.846,373188.1053,2016-08-01,573529,43791497,50469264,8424724
"3275","42439324660000",1992702.846,373188.1053,2016-09-01,532599,44324096,50469264,7958587
"3276","42439324660000",1992702.846,373188.1053,2016-10-01,536425,44860521,50469264,7328643
"3277","42439324660000",1992702.846,373188.1053,2016-11-01,528732,45389253,50469264,7108192
"3278","42439324660000",1992702.846,373188.1053,2016-12-01,582936,45972189,50469264,7206177
"3279","42439324660000",1992702.846,373188.1053,2017-01-01,590317,46562506,50469264,8191419
"3280","42439324660000",1992702.846,373188.1053,2017-02-01,537193,47099699,50469264,7284679
"3281","42439324660000",1992702.846,373188.1053,2017-03-01,467614,47567313,50469264,7793859
"3282","42439324660000",1992702.846,373188.1053,2017-04-01,423307,47990620,50469264,7558837
"3283","42439324660000",1992702.846,373188.1053,2017-05-01,462905,48453525,50469264,7868617
"3284","42439324660000",1992702.846,373188.1053,2017-06-01,489845,48943370,50469264,7593200
"3285","42439324660000",1992702.846,373188.1053,2017-07-01,519103,49462473,50469264,8034023
"3286","42439324660000",1992702.846,373188.1053,2017-08-01,519634,49982107,50469264,8259439
"3287","42439324660000",1992702.846,373188.1053,2017-09-01,487157,50469264,50469264,7833970
"3288","42439327790000",2000479.4,407831.1569,2008-09-01,4813,4813,71635161,9513587
"3289","42439327790000",2000479.4,407831.1569,2008-10-01,269888,274701,71635161,9729575
"3290","42439327790000",2000479.4,407831.1569,2008-11-01,474267,748968,71635161,10178583
"3291","42439327790000",2000479.4,407831.1569,2008-12-01,476800,1225768,71635161,9857864
"3292","42439327790000",2000479.4,407831.1569,2009-01-01,374406,1600174,71635161,9714975
"3293","42439327790000",2000479.4,407831.1569,2009-02-01,597721,2197895,71635161,9563848
"3294","42439327790000",2000479.4,407831.1569,2009-03-01,574386,2772281,71635161,10011008
"3295","42439327790000",2000479.4,407831.1569,2009-04-01,686777,3459058,71635161,8817835
"3296","42439327790000",2000479.4,407831.1569,2009-05-01,605977,4065035,71635161,9222275
"3297","42439327790000",2000479.4,407831.1569,2009-06-01,557718,4622753,71635161,8823798
"3298","42439327790000",2000479.4,407831.1569,2009-07-01,476013,5098766,71635161,9681047
"3299","42439327790000",2000479.4,407831.1569,2009-08-01,691650,5790416,71635161,10148823
"3300","42439327790000",2000479.4,407831.1569,2009-09-01,667535,6457951,71635161,9880092
"3301","42439327790000",2000479.4,407831.1569,2009-10-01,676171,7134122,71635161,10866851
"3302","42439327790000",2000479.4,407831.1569,2009-11-01,398306,7532428,71635161,10107974
"3303","42439327790000",2000479.4,407831.1569,2009-12-01,531351,8063779,71635161,10176315
"3304","42439327790000",2000479.4,407831.1569,2010-01-01,601383,8665162,71635161,10900701
"3305","42439327790000",2000479.4,407831.1569,2010-02-01,550205,9215367,71635161,10320596
"3306","42439327790000",2000479.4,407831.1569,2010-03-01,627678,9843045,71635161,12054256
"3307","42439327790000",2000479.4,407831.1569,2010-04-01,583204,10426249,71635161,11657482
"3308","42439327790000",2000479.4,407831.1569,2010-05-01,625368,11051617,71635161,12361540
"3309","42439327790000",2000479.4,407831.1569,2010-06-01,629037,11680654,71635161,11806317
"3310","42439327790000",2000479.4,407831.1569,2010-07-01,628853,12309507,71635161,13014429
"3311","42439327790000",2000479.4,407831.1569,2010-08-01,608790,12918297,71635161,12894731
"3312","42439327790000",2000479.4,407831.1569,2010-09-01,618162,13536459,71635161,13014299
"3313","42439327790000",2000479.4,407831.1569,2010-10-01,586201,14122660,71635161,11689154
"3314","42439327790000",2000479.4,407831.1569,2010-11-01,652489,14775149,71635161,11954124
"3315","42439327790000",2000479.4,407831.1569,2010-12-01,714027,15489176,71635161,12386935
"3316","42439327790000",2000479.4,407831.1569,2011-01-01,726486,16215662,71635161,12491622
"3317","42439327790000",2000479.4,407831.1569,2011-02-01,717018,16932680,71635161,10744516
"3318","42439327790000",2000479.4,407831.1569,2011-03-01,747154,17679834,71635161,13585658
"3319","42439327790000",2000479.4,407831.1569,2011-04-01,676865,18356699,71635161,13823700
"3320","42439327790000",2000479.4,407831.1569,2011-05-01,663778,19020477,71635161,14893483
"3321","42439327790000",2000479.4,407831.1569,2011-06-01,673047,19693524,71635161,13536023
"3322","42439327790000",2000479.4,407831.1569,2011-07-01,723157,20416681,71635161,14060435
"3323","42439327790000",2000479.4,407831.1569,2011-08-01,711247,21127928,71635161,13865713
"3324","42439327790000",2000479.4,407831.1569,2011-09-01,706445,21834373,71635161,13575950
"3325","42439327790000",2000479.4,407831.1569,2011-10-01,726575,22560948,71635161,14224672
"3326","42439327790000",2000479.4,407831.1569,2011-11-01,726873,23287821,71635161,14289379
"3327","42439327790000",2000479.4,407831.1569,2011-12-01,752846,24040667,71635161,14301497
"3328","42439327790000",2000479.4,407831.1569,2012-01-01,733894,24774561,71635161,14393197
"3329","42439327790000",2000479.4,407831.1569,2012-02-01,713625,25488186,71635161,13261820
"3330","42439327790000",2000479.4,407831.1569,2012-03-01,744643,26232829,71635161,14719295
"3331","42439327790000",2000479.4,407831.1569,2012-04-01,736304,26969133,71635161,13422939
"3332","42439327790000",2000479.4,407831.1569,2012-05-01,750876,27720009,71635161,13619470
"3333","42439327790000",2000479.4,407831.1569,2012-06-01,719101,28439110,71635161,12965656
"3334","42439327790000",2000479.4,407831.1569,2012-07-01,754467,29193577,71635161,13735215
"3335","42439327790000",2000479.4,407831.1569,2012-08-01,764870,29958447,71635161,13116786
"3336","42439327790000",2000479.4,407831.1569,2012-09-01,697549,30655996,71635161,12508392
"3337","42439327790000",2000479.4,407831.1569,2012-10-01,716593,31372589,71635161,12829987
"3338","42439327790000",2000479.4,407831.1569,2012-11-01,677274,32049863,71635161,11811242
"3339","42439327790000",2000479.4,407831.1569,2012-12-01,721371,32771234,71635161,12077125
"3340","42439327790000",2000479.4,407831.1569,2013-01-01,744623,33515857,71635161,12754328
"3341","42439327790000",2000479.4,407831.1569,2013-02-01,660392,34176249,71635161,11309584
"3342","42439327790000",2000479.4,407831.1569,2013-03-01,722175,34898424,71635161,12445227
"3343","42439327790000",2000479.4,407831.1569,2013-04-01,710910,35609334,71635161,11899338
"3344","42439327790000",2000479.4,407831.1569,2013-05-01,709541,36318875,71635161,11963242
"3345","42439327790000",2000479.4,407831.1569,2013-06-01,696308,37015183,71635161,11514151
"3346","42439327790000",2000479.4,407831.1569,2013-07-01,569225,37584408,71635161,12334827
"3347","42439327790000",2000479.4,407831.1569,2013-08-01,451057,38035465,71635161,12036527
"3348","42439327790000",2000479.4,407831.1569,2013-09-01,893485,38928950,71635161,11831621
"3349","42439327790000",2000479.4,407831.1569,2013-10-01,982237,39911187,71635161,11912081
"3350","42439327790000",2000479.4,407831.1569,2013-11-01,921943,40833130,71635161,11402351
"3351","42439327790000",2000479.4,407831.1569,2013-12-01,827755,41660885,71635161,10800800
"3352","42439327790000",2000479.4,407831.1569,2014-01-01,181085,41841970,71635161,11386084
"3353","42439327790000",2000479.4,407831.1569,2014-02-01,800,41842770,71635161,9936683
"3354","42439327790000",2000479.4,407831.1569,2014-03-01,613328,42456098,71635161,12046987
"3355","42439327790000",2000479.4,407831.1569,2014-04-01,753261,43209359,71635161,11738869
"3356","42439327790000",2000479.4,407831.1569,2014-05-01,814499,44023858,71635161,12165041
"3357","42439327790000",2000479.4,407831.1569,2014-06-01,736677,44760535,71635161,11720072
"3358","42439327790000",2000479.4,407831.1569,2014-07-01,811309,45571844,71635161,11632955
"3359","42439327790000",2000479.4,407831.1569,2014-08-01,824362,46396206,71635161,11280396
"3360","42439327790000",2000479.4,407831.1569,2014-09-01,877975,47274181,71635161,10707843
"3361","42439327790000",2000479.4,407831.1569,2014-10-01,913230,48187411,71635161,11154961
"3362","42439327790000",2000479.4,407831.1569,2014-11-01,962521,49149932,71635161,11006198
"3363","42439327790000",2000479.4,407831.1569,2014-12-01,912041,50061973,71635161,11175048
"3364","42439327790000",2000479.4,407831.1569,2015-01-01,872500,50934473,71635161,11188192
"3365","42439327790000",2000479.4,407831.1569,2015-02-01,794034,51728507,71635161,9285348
"3366","42439327790000",2000479.4,407831.1569,2015-03-01,793702,52522209,71635161,11132951
"3367","42439327790000",2000479.4,407831.1569,2015-04-01,799019,53321228,71635161,10228970
"3368","42439327790000",2000479.4,407831.1569,2015-05-01,955568,54276796,71635161,10731832
"3369","42439327790000",2000479.4,407831.1569,2015-06-01,930483,55207279,71635161,10019178
"3370","42439327790000",2000479.4,407831.1569,2015-07-01,882486,56089765,71635161,9556838
"3371","42439327790000",2000479.4,407831.1569,2015-08-01,776264,56866029,71635161,9046352
"3372","42439327790000",2000479.4,407831.1569,2015-09-01,750982,57617011,71635161,8436833
"3373","42439327790000",2000479.4,407831.1569,2015-10-01,820606,58437617,71635161,8702949
"3374","42439327790000",2000479.4,407831.1569,2015-11-01,742179,59179796,71635161,8702391
"3375","42439327790000",2000479.4,407831.1569,2015-12-01,883964,60063760,71635161,8797617
"3376","42439327790000",2000479.4,407831.1569,2016-01-01,794986,60858746,71635161,8785697
"3377","42439327790000",2000479.4,407831.1569,2016-02-01,610034,61468780,71635161,8098391
"3378","42439327790000",2000479.4,407831.1569,2016-03-01,730582,62199362,71635161,8313445
"3379","42439327790000",2000479.4,407831.1569,2016-04-01,344776,62544138,71635161,8067410
"3380","42439327790000",2000479.4,407831.1569,2016-05-01,414907,62959045,71635161,8687363
"3381","42439327790000",2000479.4,407831.1569,2016-06-01,545945,63504990,71635161,8474598
"3382","42439327790000",2000479.4,407831.1569,2016-07-01,419605,63924595,71635161,8474294
"3383","42439327790000",2000479.4,407831.1569,2016-08-01,520821,64445416,71635161,8424724
"3384","42439327790000",2000479.4,407831.1569,2016-09-01,459924,64905340,71635161,7958587
"3385","42439327790000",2000479.4,407831.1569,2016-10-01,442436,65347776,71635161,7328643
"3386","42439327790000",2000479.4,407831.1569,2016-11-01,492808,65840584,71635161,7108192
"3387","42439327790000",2000479.4,407831.1569,2016-12-01,465939,66306523,71635161,7206177
"3388","42439327790000",2000479.4,407831.1569,2017-01-01,522919,66829442,71635161,8191419
"3389","42439327790000",2000479.4,407831.1569,2017-02-01,449729,67279171,71635161,7284679
"3390","42439327790000",2000479.4,407831.1569,2017-03-01,513450,67792621,71635161,7793859
"3391","42439327790000",2000479.4,407831.1569,2017-04-01,567211,68359832,71635161,7558837
"3392","42439327790000",2000479.4,407831.1569,2017-05-01,532774,68892606,71635161,7868617
"3393","42439327790000",2000479.4,407831.1569,2017-06-01,598749,69491355,71635161,7593200
"3394","42439327790000",2000479.4,407831.1569,2017-07-01,711833,70203188,71635161,8034023
"3395","42439327790000",2000479.4,407831.1569,2017-08-01,700429,70903617,71635161,8259439
"3396","42439327790000",2000479.4,407831.1569,2017-09-01,731544,71635161,71635161,7833970
"3397","42439341280000",2062473.322,475601.4824,2009-09-01,69750,69750,35142766,9880092
"3398","42439341280000",2062473.322,475601.4824,2009-10-01,373255,443005,35142766,10866851
"3399","42439341280000",2062473.322,475601.4824,2009-11-01,320817,763822,35142766,10107974
"3400","42439341280000",2062473.322,475601.4824,2009-12-01,336137,1099959,35142766,10176315
"3401","42439341280000",2062473.322,475601.4824,2010-01-01,450643,1550602,35142766,10900701
"3402","42439341280000",2062473.322,475601.4824,2010-02-01,335453,1886055,35142766,10320596
"3403","42439341280000",2062473.322,475601.4824,2010-03-01,387535,2273590,35142766,12054256
"3404","42439341280000",2062473.322,475601.4824,2010-04-01,470507,2744097,35142766,11657482
"3405","42439341280000",2062473.322,475601.4824,2010-05-01,520181,3264278,35142766,12361540
"3406","42439341280000",2062473.322,475601.4824,2010-06-01,492676,3756954,35142766,11806317
"3407","42439341280000",2062473.322,475601.4824,2010-07-01,471764,4228718,35142766,13014429
"3408","42439341280000",2062473.322,475601.4824,2010-08-01,491172,4719890,35142766,12894731
"3409","42439341280000",2062473.322,475601.4824,2010-09-01,459434,5179324,35142766,13014299
"3410","42439341280000",2062473.322,475601.4824,2010-10-01,381516,5560840,35142766,11689154
"3411","42439341280000",2062473.322,475601.4824,2010-11-01,383397,5944237,35142766,11954124
"3412","42439341280000",2062473.322,475601.4824,2010-12-01,451165,6395402,35142766,12386935
"3413","42439341280000",2062473.322,475601.4824,2011-01-01,419325,6814727,35142766,12491622
"3414","42439341280000",2062473.322,475601.4824,2011-02-01,355014,7169741,35142766,10744516
"3415","42439341280000",2062473.322,475601.4824,2011-03-01,395255,7564996,35142766,13585658
"3416","42439341280000",2062473.322,475601.4824,2011-04-01,455559,8020555,35142766,13823700
"3417","42439341280000",2062473.322,475601.4824,2011-05-01,499957,8520512,35142766,14893483
"3418","42439341280000",2062473.322,475601.4824,2011-06-01,462749,8983261,35142766,13536023
"3419","42439341280000",2062473.322,475601.4824,2011-07-01,505917,9489178,35142766,14060435
"3420","42439341280000",2062473.322,475601.4824,2011-08-01,529744,10018922,35142766,13865713
"3421","42439341280000",2062473.322,475601.4824,2011-09-01,493397,10512319,35142766,13575950
"3422","42439341280000",2062473.322,475601.4824,2011-10-01,508524,11020843,35142766,14224672
"3423","42439341280000",2062473.322,475601.4824,2011-11-01,496296,11517139,35142766,14289379
"3424","42439341280000",2062473.322,475601.4824,2011-12-01,502304,12019443,35142766,14301497
"3425","42439341280000",2062473.322,475601.4824,2012-01-01,438005,12457448,35142766,14393197
"3426","42439341280000",2062473.322,475601.4824,2012-02-01,363229,12820677,35142766,13261820
"3427","42439341280000",2062473.322,475601.4824,2012-03-01,370578,13191255,35142766,14719295
"3428","42439341280000",2062473.322,475601.4824,2012-04-01,353893,13545148,35142766,13422939
"3429","42439341280000",2062473.322,475601.4824,2012-05-01,312047,13857195,35142766,13619470
"3430","42439341280000",2062473.322,475601.4824,2012-06-01,436620,14293815,35142766,12965656
"3431","42439341280000",2062473.322,475601.4824,2012-07-01,535198,14829013,35142766,13735215
"3432","42439341280000",2062473.322,475601.4824,2012-08-01,457398,15286411,35142766,13116786
"3433","42439341280000",2062473.322,475601.4824,2012-09-01,365032,15651443,35142766,12508392
"3434","42439341280000",2062473.322,475601.4824,2012-10-01,322539,15973982,35142766,12829987
"3435","42439341280000",2062473.322,475601.4824,2012-11-01,327640,16301622,35142766,11811242
"3436","42439341280000",2062473.322,475601.4824,2012-12-01,340093,16641715,35142766,12077125
"3437","42439341280000",2062473.322,475601.4824,2013-01-01,242020,16883735,35142766,12754328
"3438","42439341280000",2062473.322,475601.4824,2013-02-01,254690,17138425,35142766,11309584
"3439","42439341280000",2062473.322,475601.4824,2013-03-01,267803,17406228,35142766,12445227
"3440","42439341280000",2062473.322,475601.4824,2013-04-01,324426,17730654,35142766,11899338
"3441","42439341280000",2062473.322,475601.4824,2013-05-01,414276,18144930,35142766,11963242
"3442","42439341280000",2062473.322,475601.4824,2013-06-01,375923,18520853,35142766,11514151
"3443","42439341280000",2062473.322,475601.4824,2013-07-01,407519,18928372,35142766,12334827
"3444","42439341280000",2062473.322,475601.4824,2013-08-01,468456,19396828,35142766,12036527
"3445","42439341280000",2062473.322,475601.4824,2013-09-01,451815,19848643,35142766,11831621
"3446","42439341280000",2062473.322,475601.4824,2013-10-01,439952,20288595,35142766,11912081
"3447","42439341280000",2062473.322,475601.4824,2013-11-01,399001,20687596,35142766,11402351
"3448","42439341280000",2062473.322,475601.4824,2013-12-01,412270,21099866,35142766,10800800
"3449","42439341280000",2062473.322,475601.4824,2014-01-01,381926,21481792,35142766,11386084
"3450","42439341280000",2062473.322,475601.4824,2014-02-01,362552,21844344,35142766,9936683
"3451","42439341280000",2062473.322,475601.4824,2014-03-01,446508,22290852,35142766,12046987
"3452","42439341280000",2062473.322,475601.4824,2014-04-01,446434,22737286,35142766,11738869
"3453","42439341280000",2062473.322,475601.4824,2014-05-01,430648,23167934,35142766,12165041
"3454","42439341280000",2062473.322,475601.4824,2014-06-01,325452,23493386,35142766,11720072
"3455","42439341280000",2062473.322,475601.4824,2014-07-01,330976,23824362,35142766,11632955
"3456","42439341280000",2062473.322,475601.4824,2014-08-01,329632,24153994,35142766,11280396
"3457","42439341280000",2062473.322,475601.4824,2014-09-01,308007,24462001,35142766,10707843
"3458","42439341280000",2062473.322,475601.4824,2014-10-01,252918,24714919,35142766,11154961
"3459","42439341280000",2062473.322,475601.4824,2014-11-01,301225,25016144,35142766,11006198
"3460","42439341280000",2062473.322,475601.4824,2014-12-01,1e+05,28243684,35142766,11175048
"3461","42439341280000",2062473.322,475601.4824,2015-01-01,332199,28575883,35142766,11188192
"3462","42439341280000",2062473.322,475601.4824,2015-02-01,291915,28867798,35142766,9285348
"3463","42439341280000",2062473.322,475601.4824,2015-03-01,273297,29141095,35142766,11132951
"3464","42439341280000",2062473.322,475601.4824,2015-04-01,299048,29440143,35142766,10228970
"3465","42439341280000",2062473.322,475601.4824,2015-05-01,253963,29694106,35142766,10731832
"3466","42439341280000",2062473.322,475601.4824,2015-06-01,169779,29863885,35142766,10019178
"3467","42439341280000",2062473.322,475601.4824,2015-07-01,130964,29994849,35142766,9556838
"3468","42439341280000",2062473.322,475601.4824,2015-08-01,174015,30168864,35142766,9046352
"3469","42439341280000",2062473.322,475601.4824,2015-09-01,210881,30379745,35142766,8436833
"3470","42439341280000",2062473.322,475601.4824,2015-10-01,168429,30548174,35142766,8702949
"3471","42439341280000",2062473.322,475601.4824,2015-11-01,132465,30680639,35142766,8702391
"3472","42439341280000",2062473.322,475601.4824,2015-12-01,119565,30800204,35142766,8797617
"3473","42439341280000",2062473.322,475601.4824,2016-01-01,133954,30934158,35142766,8785697
"3474","42439341280000",2062473.322,475601.4824,2016-02-01,141161,31075319,35142766,8098391
"3475","42439341280000",2062473.322,475601.4824,2016-03-01,83690,31159009,35142766,8313445
"3476","42439341280000",2062473.322,475601.4824,2016-04-01,148815,31307824,35142766,8067410
"3477","42439341280000",2062473.322,475601.4824,2016-05-01,167905,31475729,35142766,8687363
"3478","42439341280000",2062473.322,475601.4824,2016-06-01,190864,31666593,35142766,8474598
"3479","42439341280000",2062473.322,475601.4824,2016-07-01,264479,31931072,35142766,8474294
"3480","42439341280000",2062473.322,475601.4824,2016-08-01,256937,32188009,35142766,8424724
"3481","42439341280000",2062473.322,475601.4824,2016-09-01,185804,32373813,35142766,7958587
"3482","42439341280000",2062473.322,475601.4824,2016-10-01,251097,32624910,35142766,7328643
"3483","42439341280000",2062473.322,475601.4824,2016-11-01,192813,32817723,35142766,7108192
"3484","42439341280000",2062473.322,475601.4824,2016-12-01,195037,33012760,35142766,7206177
"3485","42439341280000",2062473.322,475601.4824,2017-01-01,261960,33274720,35142766,8191419
"3486","42439341280000",2062473.322,475601.4824,2017-02-01,269549,33544269,35142766,7284679
"3487","42439341280000",2062473.322,475601.4824,2017-03-01,232897,33777166,35142766,7793859
"3488","42439341280000",2062473.322,475601.4824,2017-04-01,160682,33937848,35142766,7558837
"3489","42439341280000",2062473.322,475601.4824,2017-05-01,206537,34144385,35142766,7868617
"3490","42439341280000",2062473.322,475601.4824,2017-06-01,231134,34375519,35142766,7593200
"3491","42439341280000",2062473.322,475601.4824,2017-07-01,231678,34607197,35142766,8034023
"3492","42439341280000",2062473.322,475601.4824,2017-08-01,242427,34849624,35142766,8259439
"3493","42439341280000",2062473.322,475601.4824,2017-09-01,293142,35142766,35142766,7833970
"3494","42497358070000",1930346.601,551513.6645,2005-06-01,134720,134720,30864822,639936
"3495","42497358070000",1930346.601,551513.6645,2005-07-01,227541,362261,30864822,822800
"3496","42497358070000",1930346.601,551513.6645,2005-08-01,228203,590464,30864822,897133
"3497","42497358070000",1930346.601,551513.6645,2005-09-01,291304,881768,30864822,960193
"3498","42497358070000",1930346.601,551513.6645,2005-10-01,245250,1127018,30864822,1037267
"3499","42497358070000",1930346.601,551513.6645,2005-11-01,202548,1329566,30864822,1075049
"3500","42497358070000",1930346.601,551513.6645,2005-12-01,196099,1525665,30864822,1200947
"3501","42497358070000",1930346.601,551513.6645,2006-01-01,181941,1707606,30864822,1350182
"3502","42497358070000",1930346.601,551513.6645,2006-02-01,189152,1896758,30864822,1472478
"3503","42497358070000",1930346.601,551513.6645,2006-03-01,273522,2170280,30864822,1848901
"3504","42497358070000",1930346.601,551513.6645,2006-04-01,233825,2404105,30864822,1923527
"3505","42497358070000",1930346.601,551513.6645,2006-05-01,288095,2692200,30864822,2207406
"3506","42497358070000",1930346.601,551513.6645,2006-06-01,244268,2936468,30864822,1973653
"3507","42497358070000",1930346.601,551513.6645,2006-07-01,214526,3150994,30864822,2021893
"3508","42497358070000",1930346.601,551513.6645,2006-08-01,287123,3438117,30864822,2512715
"3509","42497358070000",1930346.601,551513.6645,2006-09-01,224581,3662698,30864822,2773616
"3510","42497358070000",1930346.601,551513.6645,2006-10-01,231932,3894630,30864822,3124548
"3511","42497358070000",1930346.601,551513.6645,2006-11-01,174568,4069198,30864822,3240926
"3512","42497358070000",1930346.601,551513.6645,2006-12-01,205294,4274492,30864822,4484941
"3513","42497358070000",1930346.601,551513.6645,2007-01-01,186520,4461012,30864822,4380773
"3514","42497358070000",1930346.601,551513.6645,2007-02-01,180898,4641910,30864822,4175393
"3515","42497358070000",1930346.601,551513.6645,2007-03-01,134599,4776509,30864822,4620840
"3516","42497358070000",1930346.601,551513.6645,2007-04-01,220605,4997114,30864822,4876542
"3517","42497358070000",1930346.601,551513.6645,2007-05-01,245042,5242156,30864822,5347071
"3518","42497358070000",1930346.601,551513.6645,2007-06-01,229035,5471191,30864822,5055569
"3519","42497358070000",1930346.601,551513.6645,2007-07-01,247469,5718660,30864822,5639953
"3520","42497358070000",1930346.601,551513.6645,2007-08-01,261520,5980180,30864822,5967755
"3521","42497358070000",1930346.601,551513.6645,2007-09-01,263595,6243775,30864822,5629384
"3522","42497358070000",1930346.601,551513.6645,2007-10-01,201494,6445269,30864822,6483309
"3523","42497358070000",1930346.601,551513.6645,2007-11-01,183393,6628662,30864822,6157035
"3524","42497358070000",1930346.601,551513.6645,2007-12-01,207273,6835935,30864822,5777613
"3525","42497358070000",1930346.601,551513.6645,2008-01-01,181688,7017623,30864822,6452815
"3526","42497358070000",1930346.601,551513.6645,2008-02-01,205870,7223493,30864822,7775520
"3527","42497358070000",1930346.601,551513.6645,2008-03-01,240598,7464091,30864822,9152519
"3528","42497358070000",1930346.601,551513.6645,2008-04-01,223856,7687947,30864822,8881211
"3529","42497358070000",1930346.601,551513.6645,2008-05-01,278517,7966464,30864822,9790992
"3530","42497358070000",1930346.601,551513.6645,2008-06-01,251992,8218456,30864822,9489076
"3531","42497358070000",1930346.601,551513.6645,2008-07-01,293623,8512079,30864822,9342850
"3532","42497358070000",1930346.601,551513.6645,2008-08-01,289221,8801300,30864822,9977335
"3533","42497358070000",1930346.601,551513.6645,2008-09-01,336013,9137313,30864822,9513587
"3534","42497358070000",1930346.601,551513.6645,2008-10-01,327233,9464546,30864822,9729575
"3535","42497358070000",1930346.601,551513.6645,2008-11-01,326979,9791525,30864822,10178583
"3536","42497358070000",1930346.601,551513.6645,2008-12-01,362535,10154060,30864822,9857864
"3537","42497358070000",1930346.601,551513.6645,2009-01-01,359283,10513343,30864822,9714975
"3538","42497358070000",1930346.601,551513.6645,2009-02-01,232901,10746244,30864822,9563848
"3539","42497358070000",1930346.601,551513.6645,2009-03-01,335120,11081364,30864822,10011008
"3540","42497358070000",1930346.601,551513.6645,2009-04-01,397745,11479109,30864822,8817835
"3541","42497358070000",1930346.601,551513.6645,2009-05-01,262624,11741733,30864822,9222275
"3542","42497358070000",1930346.601,551513.6645,2009-06-01,295274,12037007,30864822,8823798
"3543","42497358070000",1930346.601,551513.6645,2009-07-01,295274,12332281,30864822,9681047
"3544","42497358070000",1930346.601,551513.6645,2009-08-01,232818,12565099,30864822,10148823
"3545","42497358070000",1930346.601,551513.6645,2009-09-01,278755,12843854,30864822,9880092
"3546","42497358070000",1930346.601,551513.6645,2009-10-01,204201,13048055,30864822,10866851
"3547","42497358070000",1930346.601,551513.6645,2009-11-01,220918,13268973,30864822,10107974
"3548","42497358070000",1930346.601,551513.6645,2009-12-01,202313,13471286,30864822,10176315
"3549","42497358070000",1930346.601,551513.6645,2010-01-01,257206,13728492,30864822,10900701
"3550","42497358070000",1930346.601,551513.6645,2010-02-01,205133,13933625,30864822,10320596
"3551","42497358070000",1930346.601,551513.6645,2010-03-01,234725,14168350,30864822,12054256
"3552","42497358070000",1930346.601,551513.6645,2010-04-01,221770,14390120,30864822,11657482
"3553","42497358070000",1930346.601,551513.6645,2010-05-01,234681,14624801,30864822,12361540
"3554","42497358070000",1930346.601,551513.6645,2010-06-01,226014,14850815,30864822,11806317
"3555","42497358070000",1930346.601,551513.6645,2010-07-01,276536,15127351,30864822,13014429
"3556","42497358070000",1930346.601,551513.6645,2010-08-01,283449,15410800,30864822,12894731
"3557","42497358070000",1930346.601,551513.6645,2010-09-01,318185,15728985,30864822,13014299
"3558","42497358070000",1930346.601,551513.6645,2010-10-01,291702,16020687,30864822,11689154
"3559","42497358070000",1930346.601,551513.6645,2010-11-01,314694,16335381,30864822,11954124
"3560","42497358070000",1930346.601,551513.6645,2010-12-01,300870,16636251,30864822,12386935
"3561","42497358070000",1930346.601,551513.6645,2011-01-01,298499,16934750,30864822,12491622
"3562","42497358070000",1930346.601,551513.6645,2011-02-01,194595,17129345,30864822,10744516
"3563","42497358070000",1930346.601,551513.6645,2011-03-01,228667,17358012,30864822,13585658
"3564","42497358070000",1930346.601,551513.6645,2011-04-01,202370,17560382,30864822,13823700
"3565","42497358070000",1930346.601,551513.6645,2011-05-01,274333,17834715,30864822,14893483
"3566","42497358070000",1930346.601,551513.6645,2011-06-01,325286,18160001,30864822,13536023
"3567","42497358070000",1930346.601,551513.6645,2011-07-01,292784,18452785,30864822,14060435
"3568","42497358070000",1930346.601,551513.6645,2011-08-01,292784,18745569,30864822,13865713
"3569","42497358070000",1930346.601,551513.6645,2011-09-01,231627,18977196,30864822,13575950
"3570","42497358070000",1930346.601,551513.6645,2011-10-01,213689,19190885,30864822,14224672
"3571","42497358070000",1930346.601,551513.6645,2011-11-01,201700,19392585,30864822,14289379
"3572","42497358070000",1930346.601,551513.6645,2011-12-01,192231,19584816,30864822,14301497
"3573","42497358070000",1930346.601,551513.6645,2012-01-01,180951,19765767,30864822,14393197
"3574","42497358070000",1930346.601,551513.6645,2012-02-01,220473,19986240,30864822,13261820
"3575","42497358070000",1930346.601,551513.6645,2012-03-01,222717,20208957,30864822,14719295
"3576","42497358070000",1930346.601,551513.6645,2012-04-01,254560,20463517,30864822,13422939
"3577","42497358070000",1930346.601,551513.6645,2012-05-01,225990,20689507,30864822,13619470
"3578","42497358070000",1930346.601,551513.6645,2012-06-01,151610,20841117,30864822,12965656
"3579","42497358070000",1930346.601,551513.6645,2012-07-01,149128,20990245,30864822,13735215
"3580","42497358070000",1930346.601,551513.6645,2012-08-01,180121,21170366,30864822,13116786
"3581","42497358070000",1930346.601,551513.6645,2012-09-01,137883,21308249,30864822,12508392
"3582","42497358070000",1930346.601,551513.6645,2012-10-01,182259,21490508,30864822,12829987
"3583","42497358070000",1930346.601,551513.6645,2012-11-01,248295,21738803,30864822,11811242
"3584","42497358070000",1930346.601,551513.6645,2012-12-01,204886,21943689,30864822,12077125
"3585","42497358070000",1930346.601,551513.6645,2013-01-01,288295,22231984,30864822,12754328
"3586","42497358070000",1930346.601,551513.6645,2013-02-01,222319,22454303,30864822,11309584
"3587","42497358070000",1930346.601,551513.6645,2013-03-01,230334,22684637,30864822,12445227
"3588","42497358070000",1930346.601,551513.6645,2013-04-01,111238,22795875,30864822,11899338
"3589","42497358070000",1930346.601,551513.6645,2013-05-01,227611,23023486,30864822,11963242
"3590","42497358070000",1930346.601,551513.6645,2013-06-01,239208,23262694,30864822,11514151
"3591","42497358070000",1930346.601,551513.6645,2013-07-01,250512,23513206,30864822,12334827
"3592","42497358070000",1930346.601,551513.6645,2013-08-01,266930,23780136,30864822,12036527
"3593","42497358070000",1930346.601,551513.6645,2013-09-01,229456,24009592,30864822,11831621
"3594","42497358070000",1930346.601,551513.6645,2013-10-01,183547,24193139,30864822,11912081
"3595","42497358070000",1930346.601,551513.6645,2013-11-01,202287,24395426,30864822,11402351
"3596","42497358070000",1930346.601,551513.6645,2013-12-01,175075,24570501,30864822,10800800
"3597","42497358070000",1930346.601,551513.6645,2014-01-01,224295,24794796,30864822,11386084
"3598","42497358070000",1930346.601,551513.6645,2014-02-01,175615,24970411,30864822,9936683
"3599","42497358070000",1930346.601,551513.6645,2014-03-01,249934,25220345,30864822,12046987
"3600","42497358070000",1930346.601,551513.6645,2014-04-01,266146,25486491,30864822,11738869
"3601","42497358070000",1930346.601,551513.6645,2014-05-01,208898,25695389,30864822,12165041
"3602","42497358070000",1930346.601,551513.6645,2014-06-01,217967,25913356,30864822,11720072
"3603","42497358070000",1930346.601,551513.6645,2014-07-01,205037,26118393,30864822,11632955
"3604","42497358070000",1930346.601,551513.6645,2014-08-01,216139,26334532,30864822,11280396
"3605","42497358070000",1930346.601,551513.6645,2014-09-01,210173,26544705,30864822,10707843
"3606","42497358070000",1930346.601,551513.6645,2014-10-01,232397,26777102,30864822,11154961
"3607","42497358070000",1930346.601,551513.6645,2014-11-01,202106,26979208,30864822,11006198
"3608","42497358070000",1930346.601,551513.6645,2014-12-01,160179,27139387,30864822,11175048
"3609","42497358070000",1930346.601,551513.6645,2015-01-01,138975,27278362,30864822,11188192
"3610","42497358070000",1930346.601,551513.6645,2015-02-01,136807,27415169,30864822,9285348
"3611","42497358070000",1930346.601,551513.6645,2015-03-01,203397,27618566,30864822,11132951
"3612","42497358070000",1930346.601,551513.6645,2015-04-01,199671,27818237,30864822,10228970
"3613","42497358070000",1930346.601,551513.6645,2015-05-01,260531,28078768,30864822,10731832
"3614","42497358070000",1930346.601,551513.6645,2015-06-01,177625,28256393,30864822,10019178
"3615","42497358070000",1930346.601,551513.6645,2015-07-01,169003,28425396,30864822,9556838
"3616","42497358070000",1930346.601,551513.6645,2015-08-01,127035,28552431,30864822,9046352
"3617","42497358070000",1930346.601,551513.6645,2015-09-01,127849,28680280,30864822,8436833
"3618","42497358070000",1930346.601,551513.6645,2015-10-01,114810,28795090,30864822,8702949
"3619","42497358070000",1930346.601,551513.6645,2015-11-01,146819,28941909,30864822,8702391
"3620","42497358070000",1930346.601,551513.6645,2015-12-01,98665,29040574,30864822,8797617
"3621","42497358070000",1930346.601,551513.6645,2016-01-01,129844,29170418,30864822,8785697
"3622","42497358070000",1930346.601,551513.6645,2016-02-01,86789,29257207,30864822,8098391
"3623","42497358070000",1930346.601,551513.6645,2016-03-01,92211,29349418,30864822,8313445
"3624","42497358070000",1930346.601,551513.6645,2016-04-01,75608,29425026,30864822,8067410
"3625","42497358070000",1930346.601,551513.6645,2016-05-01,64465,29489491,30864822,8687363
"3626","42497358070000",1930346.601,551513.6645,2016-06-01,10960,29500451,30864822,8474598
"3627","42497358070000",1930346.601,551513.6645,2016-07-01,57474,29557925,30864822,8474294
"3628","42497358070000",1930346.601,551513.6645,2016-08-01,68503,29626428,30864822,8424724
"3629","42497358070000",1930346.601,551513.6645,2016-09-01,81862,29708290,30864822,7958587
"3630","42497358070000",1930346.601,551513.6645,2016-10-01,85822,29794112,30864822,7328643
"3631","42497358070000",1930346.601,551513.6645,2016-11-01,87809,29881921,30864822,7108192
"3632","42497358070000",1930346.601,551513.6645,2016-12-01,85353,29967274,30864822,7206177
"3633","42497358070000",1930346.601,551513.6645,2017-01-01,91022,30058296,30864822,8191419
"3634","42497358070000",1930346.601,551513.6645,2017-02-01,104168,30162464,30864822,7284679
"3635","42497358070000",1930346.601,551513.6645,2017-03-01,127499,30289963,30864822,7793859
"3636","42497358070000",1930346.601,551513.6645,2017-04-01,95504,30385467,30864822,7558837
"3637","42497358070000",1930346.601,551513.6645,2017-05-01,96104,30481571,30864822,7868617
"3638","42497358070000",1930346.601,551513.6645,2017-06-01,88335,30569906,30864822,7593200
"3639","42497358070000",1930346.601,551513.6645,2017-07-01,90253,30660159,30864822,8034023
"3640","42497358070000",1930346.601,551513.6645,2017-08-01,66657,30726816,30864822,8259439
"3641","42497358070000",1930346.601,551513.6645,2017-09-01,138006,30864822,30864822,7833970
"3642","42497362960000",1923540.897,591956.6539,2007-10-01,127817,127817,29665206,6483309
"3643","42497362960000",1923540.897,591956.6539,2007-11-01,132883,260700,29665206,6157035
"3644","42497362960000",1923540.897,591956.6539,2007-12-01,153023,413723,29665206,5777613
"3645","42497362960000",1923540.897,591956.6539,2008-01-01,173505,587228,29665206,6452815
"3646","42497362960000",1923540.897,591956.6539,2008-02-01,162418,749646,29665206,7775520
"3647","42497362960000",1923540.897,591956.6539,2008-03-01,113607,863253,29665206,9152519
"3648","42497362960000",1923540.897,591956.6539,2008-04-01,150719,1013972,29665206,8881211
"3649","42497362960000",1923540.897,591956.6539,2008-05-01,227393,1241365,29665206,9790992
"3650","42497362960000",1923540.897,591956.6539,2008-06-01,290985,1532350,29665206,9489076
"3651","42497362960000",1923540.897,591956.6539,2008-07-01,321995,1854345,29665206,9342850
"3652","42497362960000",1923540.897,591956.6539,2008-08-01,370288,2224633,29665206,9977335
"3653","42497362960000",1923540.897,591956.6539,2008-09-01,336123,2560756,29665206,9513587
"3654","42497362960000",1923540.897,591956.6539,2008-10-01,289931,2850687,29665206,9729575
"3655","42497362960000",1923540.897,591956.6539,2008-11-01,263854,3114541,29665206,10178583
"3656","42497362960000",1923540.897,591956.6539,2008-12-01,327542,3442083,29665206,9857864
"3657","42497362960000",1923540.897,591956.6539,2009-01-01,295104,3737187,29665206,9714975
"3658","42497362960000",1923540.897,591956.6539,2009-02-01,317347,4054534,29665206,9563848
"3659","42497362960000",1923540.897,591956.6539,2009-03-01,341314,4395848,29665206,10011008
"3660","42497362960000",1923540.897,591956.6539,2009-04-01,385675,4781523,29665206,8817835
"3661","42497362960000",1923540.897,591956.6539,2009-05-01,367252,5148775,29665206,9222275
"3662","42497362960000",1923540.897,591956.6539,2009-06-01,384317,5533092,29665206,8823798
"3663","42497362960000",1923540.897,591956.6539,2009-07-01,349848,5882940,29665206,9681047
"3664","42497362960000",1923540.897,591956.6539,2009-08-01,433839,6316779,29665206,10148823
"3665","42497362960000",1923540.897,591956.6539,2009-09-01,400946,6717725,29665206,9880092
"3666","42497362960000",1923540.897,591956.6539,2009-10-01,332885,7050610,29665206,10866851
"3667","42497362960000",1923540.897,591956.6539,2009-11-01,251780,7302390,29665206,10107974
"3668","42497362960000",1923540.897,591956.6539,2009-12-01,280758,7583148,29665206,10176315
"3669","42497362960000",1923540.897,591956.6539,2010-01-01,370406,7953554,29665206,10900701
"3670","42497362960000",1923540.897,591956.6539,2010-02-01,350925,8304479,29665206,10320596
"3671","42497362960000",1923540.897,591956.6539,2010-03-01,395524,8700003,29665206,12054256
"3672","42497362960000",1923540.897,591956.6539,2010-04-01,384285,9084288,29665206,11657482
"3673","42497362960000",1923540.897,591956.6539,2010-05-01,410623,9494911,29665206,12361540
"3674","42497362960000",1923540.897,591956.6539,2010-06-01,394460,9889371,29665206,11806317
"3675","42497362960000",1923540.897,591956.6539,2010-07-01,428116,10317487,29665206,13014429
"3676","42497362960000",1923540.897,591956.6539,2010-08-01,375122,10692609,29665206,12894731
"3677","42497362960000",1923540.897,591956.6539,2010-09-01,404958,11097567,29665206,13014299
"3678","42497362960000",1923540.897,591956.6539,2010-10-01,331646,11429213,29665206,11689154
"3679","42497362960000",1923540.897,591956.6539,2010-11-01,348970,11778183,29665206,11954124
"3680","42497362960000",1923540.897,591956.6539,2010-12-01,383791,12161974,29665206,12386935
"3681","42497362960000",1923540.897,591956.6539,2011-01-01,342329,12504303,29665206,12491622
"3682","42497362960000",1923540.897,591956.6539,2011-02-01,333338,12837641,29665206,10744516
"3683","42497362960000",1923540.897,591956.6539,2011-03-01,356028,13193669,29665206,13585658
"3684","42497362960000",1923540.897,591956.6539,2011-04-01,377117,13570786,29665206,13823700
"3685","42497362960000",1923540.897,591956.6539,2011-05-01,370397,13941183,29665206,14893483
"3686","42497362960000",1923540.897,591956.6539,2011-06-01,348423,14289606,29665206,13536023
"3687","42497362960000",1923540.897,591956.6539,2011-07-01,349882,14639488,29665206,14060435
"3688","42497362960000",1923540.897,591956.6539,2011-08-01,329450,14968938,29665206,13865713
"3689","42497362960000",1923540.897,591956.6539,2011-09-01,347340,15316278,29665206,13575950
"3690","42497362960000",1923540.897,591956.6539,2011-10-01,380939,15697217,29665206,14224672
"3691","42497362960000",1923540.897,591956.6539,2011-11-01,287238,15984455,29665206,14289379
"3692","42497362960000",1923540.897,591956.6539,2011-12-01,268773,16253228,29665206,14301497
"3693","42497362960000",1923540.897,591956.6539,2012-01-01,311032,16564260,29665206,14393197
"3694","42497362960000",1923540.897,591956.6539,2012-02-01,261789,16826049,29665206,13261820
"3695","42497362960000",1923540.897,591956.6539,2012-03-01,251498,17077547,29665206,14719295
"3696","42497362960000",1923540.897,591956.6539,2012-04-01,296972,17374519,29665206,13422939
"3697","42497362960000",1923540.897,591956.6539,2012-05-01,286642,17661161,29665206,13619470
"3698","42497362960000",1923540.897,591956.6539,2012-06-01,306606,17967767,29665206,12965656
"3699","42497362960000",1923540.897,591956.6539,2012-07-01,278813,18246580,29665206,13735215
"3700","42497362960000",1923540.897,591956.6539,2012-08-01,234665,18481245,29665206,13116786
"3701","42497362960000",1923540.897,591956.6539,2012-09-01,240438,18721683,29665206,12508392
"3702","42497362960000",1923540.897,591956.6539,2012-10-01,239477,18961160,29665206,12829987
"3703","42497362960000",1923540.897,591956.6539,2012-11-01,239820,19200980,29665206,11811242
"3704","42497362960000",1923540.897,591956.6539,2012-12-01,209581,19410561,29665206,12077125
"3705","42497362960000",1923540.897,591956.6539,2013-01-01,213865,19624426,29665206,12754328
"3706","42497362960000",1923540.897,591956.6539,2013-02-01,282840,19907266,29665206,11309584
"3707","42497362960000",1923540.897,591956.6539,2013-03-01,306691,20213957,29665206,12445227
"3708","42497362960000",1923540.897,591956.6539,2013-04-01,329851,20543808,29665206,11899338
"3709","42497362960000",1923540.897,591956.6539,2013-05-01,272395,20816203,29665206,11963242
"3710","42497362960000",1923540.897,591956.6539,2013-06-01,265429,21081632,29665206,11514151
"3711","42497362960000",1923540.897,591956.6539,2013-07-01,276018,21357650,29665206,12334827
"3712","42497362960000",1923540.897,591956.6539,2013-08-01,246056,21603706,29665206,12036527
"3713","42497362960000",1923540.897,591956.6539,2013-09-01,268162,21871868,29665206,11831621
"3714","42497362960000",1923540.897,591956.6539,2013-10-01,190925,22062793,29665206,11912081
"3715","42497362960000",1923540.897,591956.6539,2013-11-01,280660,22343453,29665206,11402351
"3716","42497362960000",1923540.897,591956.6539,2013-12-01,287437,22630890,29665206,10800800
"3717","42497362960000",1923540.897,591956.6539,2014-01-01,232918,22863808,29665206,11386084
"3718","42497362960000",1923540.897,591956.6539,2014-02-01,293014,23156822,29665206,9936683
"3719","42497362960000",1923540.897,591956.6539,2014-03-01,411309,23568131,29665206,12046987
"3720","42497362960000",1923540.897,591956.6539,2014-04-01,292999,23861130,29665206,11738869
"3721","42497362960000",1923540.897,591956.6539,2014-05-01,350106,24211236,29665206,12165041
"3722","42497362960000",1923540.897,591956.6539,2014-06-01,259539,24470775,29665206,11720072
"3723","42497362960000",1923540.897,591956.6539,2014-07-01,260769,24731544,29665206,11632955
"3724","42497362960000",1923540.897,591956.6539,2014-08-01,219425,24950969,29665206,11280396
"3725","42497362960000",1923540.897,591956.6539,2014-09-01,251574,25202543,29665206,10707843
"3726","42497362960000",1923540.897,591956.6539,2014-10-01,215937,25418480,29665206,11154961
"3727","42497362960000",1923540.897,591956.6539,2014-11-01,168804,25587284,29665206,11006198
"3728","42497362960000",1923540.897,591956.6539,2014-12-01,199555,25786839,29665206,11175048
"3729","42497362960000",1923540.897,591956.6539,2015-01-01,168931,25955770,29665206,11188192
"3730","42497362960000",1923540.897,591956.6539,2015-02-01,112807,26068577,29665206,9285348
"3731","42497362960000",1923540.897,591956.6539,2015-03-01,162220,26230797,29665206,11132951
"3732","42497362960000",1923540.897,591956.6539,2015-04-01,61396,26292193,29665206,10228970
"3733","42497362960000",1923540.897,591956.6539,2015-05-01,58466,26350659,29665206,10731832
"3734","42497362960000",1923540.897,591956.6539,2015-06-01,51983,26402642,29665206,10019178
"3735","42497362960000",1923540.897,591956.6539,2015-07-01,37866,26440508,29665206,9556838
"3736","42497362960000",1923540.897,591956.6539,2015-09-01,2940,26443448,29665206,8436833
"3737","42497362960000",1923540.897,591956.6539,2015-10-01,176758,26620206,29665206,8702949
"3738","42497362960000",1923540.897,591956.6539,2015-11-01,167258,26787464,29665206,8702391
"3739","42497362960000",1923540.897,591956.6539,2016-01-01,178366,26965830,29665206,8785697
"3740","42497362960000",1923540.897,591956.6539,2016-02-01,166216,27132046,29665206,8098391
"3741","42497362960000",1923540.897,591956.6539,2016-03-01,190609,27322655,29665206,8313445
"3742","42497362960000",1923540.897,591956.6539,2016-04-01,41840,27364495,29665206,8067410
"3743","42497362960000",1923540.897,591956.6539,2016-05-01,203632,27568127,29665206,8687363
"3744","42497362960000",1923540.897,591956.6539,2016-06-01,223621,27791748,29665206,8474598
"3745","42497362960000",1923540.897,591956.6539,2016-07-01,213263,28005011,29665206,8474294
"3746","42497362960000",1923540.897,591956.6539,2016-08-01,199398,28204409,29665206,8424724
"3747","42497362960000",1923540.897,591956.6539,2016-09-01,199727,28404136,29665206,7958587
"3748","42497362960000",1923540.897,591956.6539,2016-10-01,193712,28597848,29665206,7328643
"3749","42497362960000",1923540.897,591956.6539,2017-01-01,158556,28756404,29665206,8191419
"3750","42497362960000",1923540.897,591956.6539,2017-02-01,158303,28914707,29665206,7284679
"3751","42497362960000",1923540.897,591956.6539,2017-03-01,1650,28916357,29665206,7793859
"3752","42497362960000",1923540.897,591956.6539,2017-04-01,30409,28946766,29665206,7558837
"3753","42497362960000",1923540.897,591956.6539,2017-05-01,81418,29028184,29665206,7868617
"3754","42497362960000",1923540.897,591956.6539,2017-06-01,90858,29119042,29665206,7593200
"3755","42497362960000",1923540.897,591956.6539,2017-07-01,96827,29215869,29665206,8034023
"3756","42497362960000",1923540.897,591956.6539,2017-08-01,157067,29372936,29665206,8259439
"3757","42497362960000",1923540.897,591956.6539,2017-09-01,145167,29518103,29665206,7833970
"3758","42497362960000",1923540.897,591956.6539,2017-10-01,147103,29665206,29665206,316623
"3759","42497363170000",1959136.446,554574.7745,2009-06-01,15540,15540,29675845,8823798
"3760","42497363170000",1959136.446,554574.7745,2009-07-01,91271,106811,29675845,9681047
"3761","42497363170000",1959136.446,554574.7745,2009-08-01,71683,178494,29675845,10148823
"3762","42497363170000",1959136.446,554574.7745,2009-09-01,189349,367843,29675845,9880092
"3763","42497363170000",1959136.446,554574.7745,2009-10-01,250213,618056,29675845,10866851
"3764","42497363170000",1959136.446,554574.7745,2009-11-01,203524,821580,29675845,10107974
"3765","42497363170000",1959136.446,554574.7745,2009-12-01,188661,1010241,29675845,10176315
"3766","42497363170000",1959136.446,554574.7745,2010-01-01,151899,1162140,29675845,10900701
"3767","42497363170000",1959136.446,554574.7745,2010-02-01,149850,1311990,29675845,10320596
"3768","42497363170000",1959136.446,554574.7745,2010-03-01,149850,1461840,29675845,12054256
"3769","42497363170000",1959136.446,554574.7745,2010-04-01,202689,1664529,29675845,11657482
"3770","42497363170000",1959136.446,554574.7745,2010-05-01,174611,1839140,29675845,12361540
"3771","42497363170000",1959136.446,554574.7745,2010-06-01,174611,2013751,29675845,11806317
"3772","42497363170000",1959136.446,554574.7745,2010-07-01,197917,2211668,29675845,13014429
"3773","42497363170000",1959136.446,554574.7745,2010-08-01,220455,2432123,29675845,12894731
"3774","42497363170000",1959136.446,554574.7745,2010-09-01,238797,2670920,29675845,13014299
"3775","42497363170000",1959136.446,554574.7745,2010-10-01,230066,2900986,29675845,11689154
"3776","42497363170000",1959136.446,554574.7745,2010-11-01,265606,3166592,29675845,11954124
"3777","42497363170000",1959136.446,554574.7745,2010-12-01,273377,3439969,29675845,12386935
"3778","42497363170000",1959136.446,554574.7745,2011-01-01,277460,3717429,29675845,12491622
"3779","42497363170000",1959136.446,554574.7745,2011-02-01,290511,4007940,29675845,10744516
"3780","42497363170000",1959136.446,554574.7745,2011-03-01,417210,4425150,29675845,13585658
"3781","42497363170000",1959136.446,554574.7745,2011-04-01,345081,4770231,29675845,13823700
"3782","42497363170000",1959136.446,554574.7745,2011-05-01,370985,5141216,29675845,14893483
"3783","42497363170000",1959136.446,554574.7745,2011-06-01,324316,5465532,29675845,13536023
"3784","42497363170000",1959136.446,554574.7745,2011-07-01,311929,5777461,29675845,14060435
"3785","42497363170000",1959136.446,554574.7745,2011-08-01,361628,6139089,29675845,13865713
"3786","42497363170000",1959136.446,554574.7745,2011-09-01,343870,6482959,29675845,13575950
"3787","42497363170000",1959136.446,554574.7745,2011-10-01,490056,6973015,29675845,14224672
"3788","42497363170000",1959136.446,554574.7745,2011-11-01,408095,7381110,29675845,14289379
"3789","42497363170000",1959136.446,554574.7745,2011-12-01,364621,7745731,29675845,14301497
"3790","42497363170000",1959136.446,554574.7745,2012-01-01,428645,8174376,29675845,14393197
"3791","42497363170000",1959136.446,554574.7745,2012-02-01,425199,8599575,29675845,13261820
"3792","42497363170000",1959136.446,554574.7745,2012-03-01,458277,9057852,29675845,14719295
"3793","42497363170000",1959136.446,554574.7745,2012-04-01,329649,9387501,29675845,13422939
"3794","42497363170000",1959136.446,554574.7745,2012-05-01,458612,9846113,29675845,13619470
"3795","42497363170000",1959136.446,554574.7745,2012-06-01,494610,10340723,29675845,12965656
"3796","42497363170000",1959136.446,554574.7745,2012-07-01,412608,10753331,29675845,13735215
"3797","42497363170000",1959136.446,554574.7745,2012-08-01,342300,11095631,29675845,13116786
"3798","42497363170000",1959136.446,554574.7745,2012-09-01,422790,11518421,29675845,12508392
"3799","42497363170000",1959136.446,554574.7745,2012-10-01,370335,11888756,29675845,12829987
"3800","42497363170000",1959136.446,554574.7745,2012-11-01,363669,12252425,29675845,11811242
"3801","42497363170000",1959136.446,554574.7745,2012-12-01,360563,12612988,29675845,12077125
"3802","42497363170000",1959136.446,554574.7745,2013-01-01,336785,12949773,29675845,12754328
"3803","42497363170000",1959136.446,554574.7745,2013-02-01,322276,13272049,29675845,11309584
"3804","42497363170000",1959136.446,554574.7745,2013-03-01,319655,13591704,29675845,12445227
"3805","42497363170000",1959136.446,554574.7745,2013-04-01,324725,13916429,29675845,11899338
"3806","42497363170000",1959136.446,554574.7745,2013-05-01,287012,14203441,29675845,11963242
"3807","42497363170000",1959136.446,554574.7745,2013-06-01,329314,14532755,29675845,11514151
"3808","42497363170000",1959136.446,554574.7745,2013-07-01,401123,14933878,29675845,12334827
"3809","42497363170000",1959136.446,554574.7745,2013-08-01,206750,15140628,29675845,12036527
"3810","42497363170000",1959136.446,554574.7745,2013-09-01,324794,15465422,29675845,11831621
"3811","42497363170000",1959136.446,554574.7745,2013-10-01,354903,15820325,29675845,11912081
"3812","42497363170000",1959136.446,554574.7745,2013-11-01,333001,16153326,29675845,11402351
"3813","42497363170000",1959136.446,554574.7745,2013-12-01,334834,16488160,29675845,10800800
"3814","42497363170000",1959136.446,554574.7745,2014-01-01,350185,16838345,29675845,11386084
"3815","42497363170000",1959136.446,554574.7745,2014-02-01,240747,17079092,29675845,9936683
"3816","42497363170000",1959136.446,554574.7745,2014-03-01,359544,17438636,29675845,12046987
"3817","42497363170000",1959136.446,554574.7745,2014-04-01,409809,17848445,29675845,11738869
"3818","42497363170000",1959136.446,554574.7745,2014-05-01,378021,18226466,29675845,12165041
"3819","42497363170000",1959136.446,554574.7745,2014-06-01,377579,18604045,29675845,11720072
"3820","42497363170000",1959136.446,554574.7745,2014-07-01,362681,18966726,29675845,11632955
"3821","42497363170000",1959136.446,554574.7745,2014-08-01,426267,19392993,29675845,11280396
"3822","42497363170000",1959136.446,554574.7745,2014-09-01,352426,19745419,29675845,10707843
"3823","42497363170000",1959136.446,554574.7745,2014-10-01,429241,20174660,29675845,11154961
"3824","42497363170000",1959136.446,554574.7745,2014-11-01,431046,20605706,29675845,11006198
"3825","42497363170000",1959136.446,554574.7745,2014-12-01,366395,20972101,29675845,11175048
"3826","42497363170000",1959136.446,554574.7745,2015-01-01,326192,21298293,29675845,11188192
"3827","42497363170000",1959136.446,554574.7745,2015-02-01,253576,21551869,29675845,9285348
"3828","42497363170000",1959136.446,554574.7745,2015-03-01,299555,21851424,29675845,11132951
"3829","42497363170000",1959136.446,554574.7745,2015-04-01,398121,22249545,29675845,10228970
"3830","42497363170000",1959136.446,554574.7745,2015-05-01,494320,22743865,29675845,10731832
"3831","42497363170000",1959136.446,554574.7745,2015-06-01,386098,23129963,29675845,10019178
"3832","42497363170000",1959136.446,554574.7745,2015-07-01,321443,23451406,29675845,9556838
"3833","42497363170000",1959136.446,554574.7745,2015-08-01,314218,23765624,29675845,9046352
"3834","42497363170000",1959136.446,554574.7745,2015-09-01,349632,24115256,29675845,8436833
"3835","42497363170000",1959136.446,554574.7745,2015-10-01,305436,24420692,29675845,8702949
"3836","42497363170000",1959136.446,554574.7745,2015-11-01,290851,24711543,29675845,8702391
"3837","42497363170000",1959136.446,554574.7745,2015-12-01,347631,25059174,29675845,8797617
"3838","42497363170000",1959136.446,554574.7745,2016-01-01,236610,25295784,29675845,8785697
"3839","42497363170000",1959136.446,554574.7745,2016-02-01,201145,25496929,29675845,8098391
"3840","42497363170000",1959136.446,554574.7745,2016-03-01,209968,25706897,29675845,8313445
"3841","42497363170000",1959136.446,554574.7745,2016-04-01,215226,25922123,29675845,8067410
"3842","42497363170000",1959136.446,554574.7745,2016-05-01,214375,26136498,29675845,8687363
"3843","42497363170000",1959136.446,554574.7745,2016-06-01,219666,26356164,29675845,8474598
"3844","42497363170000",1959136.446,554574.7745,2016-07-01,264081,26620245,29675845,8474294
"3845","42497363170000",1959136.446,554574.7745,2016-08-01,171708,26791953,29675845,8424724
"3846","42497363170000",1959136.446,554574.7745,2016-09-01,179216,26971169,29675845,7958587
"3847","42497363170000",1959136.446,554574.7745,2016-10-01,171405,27142574,29675845,7328643
"3848","42497363170000",1959136.446,554574.7745,2016-11-01,140664,27283238,29675845,7108192
"3849","42497363170000",1959136.446,554574.7745,2016-12-01,156267,27439505,29675845,7206177
"3850","42497363170000",1959136.446,554574.7745,2017-01-01,172117,27611622,29675845,8191419
"3851","42497363170000",1959136.446,554574.7745,2017-02-01,105585,27717207,29675845,7284679
"3852","42497363170000",1959136.446,554574.7745,2017-03-01,163309,27880516,29675845,7793859
"3853","42497363170000",1959136.446,554574.7745,2017-04-01,288191,28168707,29675845,7558837
"3854","42497363170000",1959136.446,554574.7745,2017-05-01,258811,28427518,29675845,7868617
"3855","42497363170000",1959136.446,554574.7745,2017-06-01,271636,28699154,29675845,7593200
"3856","42497363170000",1959136.446,554574.7745,2017-07-01,351307,29050461,29675845,8034023
"3857","42497363170000",1959136.446,554574.7745,2017-08-01,365727,29416188,29675845,8259439
"3858","42497363170000",1959136.446,554574.7745,2017-09-01,259657,29675845,29675845,7833970
"3859","42497368720000",2016196.762,496157.9909,2010-03-01,15120,15120,25337136,12054256
"3860","42497368720000",2016196.762,496157.9909,2010-04-01,9841,24961,25337136,11657482
"3861","42497368720000",2016196.762,496157.9909,2010-05-01,77448,102409,25337136,12361540
"3862","42497368720000",2016196.762,496157.9909,2010-06-01,95583,197992,25337136,11806317
"3863","42497368720000",2016196.762,496157.9909,2010-07-01,116692,314684,25337136,13014429
"3864","42497368720000",2016196.762,496157.9909,2010-08-01,173707,488391,25337136,12894731
"3865","42497368720000",2016196.762,496157.9909,2010-09-01,200520,688911,25337136,13014299
"3866","42497368720000",2016196.762,496157.9909,2010-10-01,296124,985035,25337136,11689154
"3867","42497368720000",2016196.762,496157.9909,2010-11-01,191802,1176837,25337136,11954124
"3868","42497368720000",2016196.762,496157.9909,2010-12-01,199356,1376193,25337136,12386935
"3869","42497368720000",2016196.762,496157.9909,2011-01-01,324466,1700659,25337136,12491622
"3870","42497368720000",2016196.762,496157.9909,2011-02-01,369075,2069734,25337136,10744516
"3871","42497368720000",2016196.762,496157.9909,2011-03-01,484008,2553742,25337136,13585658
"3872","42497368720000",2016196.762,496157.9909,2011-04-01,478867,3032609,25337136,13823700
"3873","42497368720000",2016196.762,496157.9909,2011-05-01,517573,3550182,25337136,14893483
"3874","42497368720000",2016196.762,496157.9909,2011-06-01,433877,3984059,25337136,13536023
"3875","42497368720000",2016196.762,496157.9909,2011-07-01,501228,4485287,25337136,14060435
"3876","42497368720000",2016196.762,496157.9909,2011-08-01,533964,5019251,25337136,13865713
"3877","42497368720000",2016196.762,496157.9909,2011-09-01,503037,5522288,25337136,13575950
"3878","42497368720000",2016196.762,496157.9909,2011-10-01,503799,6026087,25337136,14224672
"3879","42497368720000",2016196.762,496157.9909,2011-11-01,517223,6543310,25337136,14289379
"3880","42497368720000",2016196.762,496157.9909,2011-12-01,460992,7004302,25337136,14301497
"3881","42497368720000",2016196.762,496157.9909,2012-01-01,564051,7568353,25337136,14393197
"3882","42497368720000",2016196.762,496157.9909,2012-02-01,430517,7998870,25337136,13261820
"3883","42497368720000",2016196.762,496157.9909,2012-03-01,446415,8445285,25337136,14719295
"3884","42497368720000",2016196.762,496157.9909,2012-04-01,489701,8934986,25337136,13422939
"3885","42497368720000",2016196.762,496157.9909,2012-05-01,559252,9494238,25337136,13619470
"3886","42497368720000",2016196.762,496157.9909,2012-06-01,563673,10057911,25337136,12965656
"3887","42497368720000",2016196.762,496157.9909,2012-07-01,636177,10694088,25337136,13735215
"3888","42497368720000",2016196.762,496157.9909,2012-08-01,629525,11323613,25337136,13116786
"3889","42497368720000",2016196.762,496157.9909,2012-09-01,559048,11882661,25337136,12508392
"3890","42497368720000",2016196.762,496157.9909,2012-10-01,557722,12440383,25337136,12829987
"3891","42497368720000",2016196.762,496157.9909,2012-11-01,308417,12748800,25337136,11811242
"3892","42497368720000",2016196.762,496157.9909,2012-12-01,367424,13116224,25337136,12077125
"3893","42497368720000",2016196.762,496157.9909,2013-01-01,305882,13422106,25337136,12754328
"3894","42497368720000",2016196.762,496157.9909,2013-02-01,344916,13767022,25337136,11309584
"3895","42497368720000",2016196.762,496157.9909,2013-03-01,407469,14174491,25337136,12445227
"3896","42497368720000",2016196.762,496157.9909,2013-04-01,377310,14551801,25337136,11899338
"3897","42497368720000",2016196.762,496157.9909,2013-05-01,315126,14866927,25337136,11963242
"3898","42497368720000",2016196.762,496157.9909,2013-06-01,420313,15287240,25337136,11514151
"3899","42497368720000",2016196.762,496157.9909,2013-07-01,413942,15701182,25337136,12334827
"3900","42497368720000",2016196.762,496157.9909,2013-08-01,498643,16199825,25337136,12036527
"3901","42497368720000",2016196.762,496157.9909,2013-09-01,294516,16494341,25337136,11831621
"3902","42497368720000",2016196.762,496157.9909,2013-10-01,312,16494653,25337136,11912081
"3903","42497368720000",2016196.762,496157.9909,2013-11-01,282,16494935,25337136,11402351
"3904","42497368720000",2016196.762,496157.9909,2013-12-01,243,16495178,25337136,10800800
"3905","42497368720000",2016196.762,496157.9909,2014-01-01,393,16495571,25337136,11386084
"3906","42497368720000",2016196.762,496157.9909,2014-02-01,403,16495974,25337136,9936683
"3907","42497368720000",2016196.762,496157.9909,2014-03-01,263,16496237,25337136,12046987
"3908","42497368720000",2016196.762,496157.9909,2014-04-01,294,16496531,25337136,11738869
"3909","42497368720000",2016196.762,496157.9909,2014-05-01,310,16496841,25337136,12165041
"3910","42497368720000",2016196.762,496157.9909,2014-06-01,261,16497102,25337136,11720072
"3911","42497368720000",2016196.762,496157.9909,2014-07-01,264,16497366,25337136,11632955
"3912","42497368720000",2016196.762,496157.9909,2014-08-01,340,16497706,25337136,11280396
"3913","42497368720000",2016196.762,496157.9909,2014-09-01,393,16498099,25337136,10707843
"3914","42497368720000",2016196.762,496157.9909,2014-10-01,417197,16915296,25337136,11154961
"3915","42497368720000",2016196.762,496157.9909,2014-11-01,354305,17269601,25337136,11006198
"3916","42497368720000",2016196.762,496157.9909,2014-12-01,370268,17639869,25337136,11175048
"3917","42497368720000",2016196.762,496157.9909,2015-01-01,334340,17974209,25337136,11188192
"3918","42497368720000",2016196.762,496157.9909,2015-02-01,314422,18288631,25337136,9285348
"3919","42497368720000",2016196.762,496157.9909,2015-03-01,376745,18665376,25337136,11132951
"3920","42497368720000",2016196.762,496157.9909,2015-04-01,358143,19023519,25337136,10228970
"3921","42497368720000",2016196.762,496157.9909,2015-05-01,355187,19378706,25337136,10731832
"3922","42497368720000",2016196.762,496157.9909,2015-06-01,323384,19702090,25337136,10019178
"3923","42497368720000",2016196.762,496157.9909,2015-07-01,345449,20047539,25337136,9556838
"3924","42497368720000",2016196.762,496157.9909,2015-08-01,280989,20328528,25337136,9046352
"3925","42497368720000",2016196.762,496157.9909,2015-09-01,337552,20666080,25337136,8436833
"3926","42497368720000",2016196.762,496157.9909,2015-10-01,331682,20997762,25337136,8702949
"3927","42497368720000",2016196.762,496157.9909,2015-11-01,243524,21241286,25337136,8702391
"3928","42497368720000",2016196.762,496157.9909,2015-12-01,203897,21445183,25337136,8797617
"3929","42497368720000",2016196.762,496157.9909,2016-01-01,172784,21617967,25337136,8785697
"3930","42497368720000",2016196.762,496157.9909,2016-02-01,129685,21747652,25337136,8098391
"3931","42497368720000",2016196.762,496157.9909,2016-03-01,147244,21894896,25337136,8313445
"3932","42497368720000",2016196.762,496157.9909,2016-04-01,149260,22044156,25337136,8067410
"3933","42497368720000",2016196.762,496157.9909,2016-05-01,147244,22191400,25337136,8687363
"3934","42497368720000",2016196.762,496157.9909,2016-06-01,129504,22320904,25337136,8474598
"3935","42497368720000",2016196.762,496157.9909,2016-07-01,152279,22473183,25337136,8474294
"3936","42497368720000",2016196.762,496157.9909,2016-08-01,135561,22608744,25337136,8424724
"3937","42497368720000",2016196.762,496157.9909,2016-09-01,132127,22740871,25337136,7958587
"3938","42497368720000",2016196.762,496157.9909,2016-10-01,109456,22850327,25337136,7328643
"3939","42497368720000",2016196.762,496157.9909,2016-11-01,195566,23045893,25337136,7108192
"3940","42497368720000",2016196.762,496157.9909,2016-12-01,180162,23226055,25337136,7206177
"3941","42497368720000",2016196.762,496157.9909,2017-01-01,190062,23416117,25337136,8191419
"3942","42497368720000",2016196.762,496157.9909,2017-02-01,198031,23614148,25337136,7284679
"3943","42497368720000",2016196.762,496157.9909,2017-03-01,154535,23768683,25337136,7793859
"3944","42497368720000",2016196.762,496157.9909,2017-04-01,413128,24181811,25337136,7558837
"3945","42497368720000",2016196.762,496157.9909,2017-05-01,336897,24518708,25337136,7868617
"3946","42497368720000",2016196.762,496157.9909,2017-06-01,297152,24815860,25337136,7593200
"3947","42497368720000",2016196.762,496157.9909,2017-07-01,230911,25046771,25337136,8034023
"3948","42497368720000",2016196.762,496157.9909,2017-08-01,160723,25207494,25337136,8259439
"3949","42497368720000",2016196.762,496157.9909,2017-09-01,129642,25337136,25337136,7833970
